You regain consciousness to the sound of chains and distant machinery.

A distorted voice fills the room.

(Type HELP for list of commands)

Saw Escape Room
An Interactive Fiction by Marko Sokser
Release 1 / Serial number 260118 / Inform 7 v10.1.2 / D

Cell
You wake up strapped to a rusted metal bed in a filthy concrete cell. A heavy iron shackle locks your ankle in place, connected by a thick chain to another body nearby. Dark stains cover the floor beneath you, old and dried. The air reeks of metal, mold, and something far worse.

There are no windows. No mercy. Only waiting.

You can see:
- The unconscious man chained beside you
- The heavy iron chain binding you both
- A glowing button on the wall

I beg your pardon?

>press button
You press the button.

A section of the far wall collapses, revealing a heavy metal door.

A rusty hand saw falls from the ceiling, landing between you and the unconscious man.

Hidden machinery roars to life inside the walls.
The ceiling shudders - then begins to descend.

The ceiling grinds lower, showering you with dust and fragments of concrete.

>take saw
Taken.

The ceiling grinds lower, showering you with dust and fragments of concrete.

>saw leg
(of the man)
You saw through his ankle. His body jerks violently, but he remains unconscious. The chain finally drops.

The ceiling grinds lower, showering you with dust and fragments of concrete.

>save man
You grab him under the arms and begin dragging his limp body. Every second counts.

The ceiling grinds lower, showering you with dust and fragments of concrete.

>n
You throw yourself through the doorway, dragging him with you, as the ceiling crashes down behind you.
You both survived - at a terrible cost.

(first opening the cell exit door)

Exit Hall
A narrow concrete corridor stretches into darkness. The air is colder here, heavier. Whatever comes next, you have left the cell behind.

To the north, you can see a heavy metal door marked with biohazard symbols. Behind it, you hear the faint hum of fluorescent lights.

Marcus lies unconscious on the cold concrete floor, his bandaged ankle still seeping blood.

>n
As you enter the chamber, you notice The man's severed ankle is bleeding heavily. Blood pools beneath him, spreading across the floor. You need to do something quickly, or he won't make it.

Blood continues to pour from The man's wound. His breathing becomes more labored.

>look
Medical Chamber
You step into what appears to be an abandoned operating room. Rusted surgical tools hang from racks on blood-stained walls. A massive examination table dominates the center, covered in leather restraints. The floor is slick with something dark and viscous.

Three glass cylinders stand against the far wall, each containing a severed limb suspended in murky fluid. Above them, a digital counter reads: "SPECIMENS: 3 / 6"

The walls are lined with cabinets, some open, revealing medical supplies in various states of decay.

To the east, you can see a heavy metal door with a complex locking mechanism.

The man lies on the blood-slicked floor, unconscious. Blood pools rapidly beneath his severed ankle. He's dying!

You can see a bloody note on the floor.

The man's face is deathly pale. The pool of blood is growing rapidly.

>check cabinet
An open medical cabinet containing various supplies: - Sterile medical gauze - Surgical tape

In the open cabinet are a medical gauze and a medical tape.

The man's breathing is barely detectable. He's losing too much blood!

>take tape
Taken.

The man's body is going into shock. His pulse is fading. This is his last chance!

>take gauze
Taken.

The man's lips are turning blue. His eyes are rolling back. He's dying!

>bandage man
You quickly wrap the gauze around The man's severed ankle, securing it tightly with the medical tape. The bleeding slows and finally stops. His breathing stabilizes slightly. He might actually survive this.

>check man
The man lies unconscious on the chamber floor. His ankle is bandaged, and the bleeding has stopped. His breathing is shallow but stable.

The man's eyes suddenly flutter open. He gasps, looking around in confusion and pain. "What... where am I?" he croaks, his voice hoarse. He looks down at his bandaged ankle and then at you. "You... you saved me. I thought I was going to die in that cell."

>talk to man
Marcus looks at you with pain in his eyes. "We need to get out of here. Look for a way to open that door."

>look
Medical Chamber
You step into what appears to be an abandoned operating room. Rusted surgical tools hang from racks on blood-stained walls. A massive examination table dominates the center, covered in leather restraints. The floor is slick with something dark and viscous.

Three glass cylinders stand against the far wall, each containing a severed limb suspended in murky fluid. Above them, a digital counter reads: "SPECIMENS: 3 / 6"

The walls are lined with cabinets, some open, revealing medical supplies in various states of decay.

To the east, you can see a heavy metal door with a complex locking mechanism.

Marcus sits against the wall, clutching his bandaged ankle. His face is pale but his eyes are alert, watching you with a mixture of fear and gratitude.

You can see a bloody note on the floor.

>take note
Taken.

BZZZZT!

A loud buzzer echoes through the chamber. The lights flicker and turn red.

A distorted voice booms from hidden speakers: "YOU HAVE IGNORED THE RULES FOR TOO LONG. THE PUZZLE IS NOW ACTIVE. STEP ON THE COLORED PLATES IN THE CORRECT SEQUENCE TO UNLOCK THE DOOR. EACH MISTAKE WILL COST YOU A PIECE OF YOURSELF. YOU HAVE THREE CHANCES. FAIL THREE TIMES, AND YOU WILL NEVER LEAVE."

The pressure plates on the floor begin to glow ominously.

Marcus's voice trembles: "Oh God... we need to figure this out quickly. Look for clues!"

>check note
A blood-stained note with shaky handwriting: "The order is written in the colors of water, fire, caution, and life. Blue flows first, Red burns second, Yellow warns third, Green grows last. BLUE - RED - YELLOW - GREEN"

>step on blue plate
You step on the BLUE plate. It glows brighter and emits a low tone.

>step on red plate
You step on the RED plate. It glows brighter and emits a low tone.

>step on green
You step on the GREEN plate. It glows brighter and emits a low tone.

>step on yellow
You step on the YELLOW plate. It glows brighter and emits a low tone.

WRONG!

The mechanical device LUNGES forward with terrifying speed. Before you can react, it clamps onto your left hand. You scream as the blade severs your hand at the wrist. The machine retracts, depositing your severed hand into the collection basin.

The digital counter updates: "SPECIMENS: 4 / 6"

The pain is unbearable, but you're still alive.

Marcus screams: "NO! Oh God, your hand! Try again, but be careful!"

>undo
Medical Chamber
[Previous turn undone.]

>undo
Medical Chamber
[Previous turn undone.]

>step on yeloow
You can't see any such thing.

>z
Time passes.

>i
You are carrying:
  a bloody note
  a medical gauze
  a medical tape
  a hand saw

>z
Time passes.

>z
Time passes.

>step on yellow
You step on the YELLOW plate. It glows brighter and emits a low tone.

>step on green
You step on the GREEN plate. It glows brighter and emits a low tone.

The plates flash GREEN in sequence. You hear a heavy CLUNK as the door mechanism unlocks.

Behind you, the entrance door SLAMS shut and locks with a mechanical THUNK. There is no going back.

"You did it!" Marcus shouts. "The door is open!"

>help
> Introduction to Saw Escape Room
   Instructions for Play
   Commands
   About

>[up]
> Introduction to Saw Escape Room
   Instructions for Play
   Commands
   About

 > Introduction to Saw Escape Room
   Instructions for Play
   Commands
   About

>[up]
> Introduction to Saw Escape Room
   Instructions for Play
   Commands
   About

 > Introduction to Saw Escape Room
   Instructions for Play
   Commands
   About

>[down]
Introduction to Saw Escape Room
 > Instructions for Play
   Commands
   About

   Introduction to Saw Escape Room
 > Instructions for Play
   Commands
   About

>[down]
Introduction to Saw Escape Room
   Instructions for Play
 > Commands
   About

   Introduction to Saw Escape Room
   Instructions for Play
 > Commands
   About

>[enter]
> Movement
   Interaction
   Special Commands
   Tips

>[esc]
Introduction to Saw Escape Room
   Instructions for Play
 > Commands
   About

>[up]
Introduction to Saw Escape Room
 > Instructions for Play
   Commands
   About

   Introduction to Saw Escape Room
 > Instructions for Play
   Commands
   About

>[up]
> Introduction to Saw Escape Room
   Instructions for Play
   Commands
   About

 > Introduction to Saw Escape Room
   Instructions for Play
   Commands
   About

* * *

>[down]
Introduction to Saw Escape Room
 > Instructions for Play
   Commands
   About

   Introduction to Saw Escape Room
 > Instructions for Play
   Commands
   About

>[esc]
Medical Chamber
You step into what appears to be an abandoned operating room. Rusted surgical tools hang from racks on blood-stained walls. A massive examination table dominates the center, covered in leather restraints. The floor is slick with something dark and viscous.

Three glass cylinders stand against the far wall, each containing a severed limb suspended in murky fluid. Above them, a digital counter reads: "SPECIMENS: 3 / 6"

The walls are lined with cabinets, some open, revealing medical supplies in various states of decay.

To the east, you can see a heavy metal door with a complex locking mechanism.

Marcus sits against the wall, clutching his bandaged ankle. His face is pale but his eyes are alert, watching you with a mixture of fear and gratitude.

Four colored pressure plates (RED, BLUE, GREEN, and YELLOW) glow ominously on the floor near the chamber exit door.

>step on red
You step on the RED plate. It glows brighter and emits a low tone.

>undo
Medical Chamber
[Previous turn undone.]

>check note
A blood-stained note with shaky handwriting: "The order is written in the colors of water, fire, caution, and life. Blue flows first, Red burns second, Yellow warns third, Green grows last. BLUE - RED - YELLOW - GREEN"

>step on blue
You step on the BLUE plate. It glows brighter and emits a low tone.

>step on red
You step on the RED plate. It glows brighter and emits a low tone.

>step on yellow
You step on the YELLOW plate. It glows brighter and emits a low tone.

>step on green
You step on the GREEN plate. It glows brighter and emits a low tone.

>n
You can't go that way.

>e
(first opening the chamber exit door)

Marcus limps in behind you, leaning against the wall for support. "Another room... another trap," he mutters. "We need to be careful."

>look
Observation Room
You step into what appears to be a surveillance room. The walls are lined with cracked monitors, most displaying nothing but static. A few still flicker with grainy footage of empty corridors and cells.

High on the far wall, thin beams of light pierce through an air vent grate. The light draws your attention upward - freedom might lie beyond that vent.

A metal chair sits in the corner, and a filing cabinet stands against the wall.

The room feels claustrophobic, as if it's watching you back.

You can see a chamber exit door, a Marcus, an observation exit door, a metal chair and a filing cabinet here.

>position chair under vent
You drag the metal chair across the floor, positioning it directly beneath the air vent. It's not tall enough on its own - you'll need something else.

>move cabinet under vent
You push the heavy filing cabinet with great effort, slowly moving it across the floor until it's positioned beneath the air vent. The chair is already there. You manage to stack the cabinet and chair together, creating a precarious tower.

>reach vent
You carefully climb onto the filing cabinet, then step up onto the chair balanced on top. The tower wobbles dangerously, but you steady yourself.

You reach toward the vent grate...

SNAP!
 Hidden mechanisms activate instantly. Metal clamps shoot out from the wall, clamping around your wrists!

BOTH your wrists are locked in the mechanisms! You're suspended in the air, completely helpless.

The monitors flicker to life. A distorted figure appears on every screen - The Jigsaw Killer.

"Welcome to your final test," the voice rasps. "You've learned about sacrifice. About pain. But have you learned about TRUST?

Both your hands are locked in place. In exactly 5 minutes, these mechanisms will sever them both. You will fall, and with no hands left, you will bleed out in seconds.

But there is a way to survive..."

The voice pauses for dramatic effect.

"I will ask you ONE question. Answer correctly, and the mechanism releases. Answer incorrectly... and you die.

However, your companion knows the answer. You may ask him for help.

But here's the twist: If you ask him, HE must decide whether to help you or save himself. If he tells you the truth, you both go free. If he lies to save himself, you die and he escapes alone.

The choice is yours. Do you trust him with your life?"

The question appears on all the monitors:

"WHAT IS THE ONE THING THAT CAN BE GIVEN, BUT NEVER TAKEN BACK?"

The monitors display: "ANSWER THE QUESTION OR ASK YOUR COMPANION. TIME IS RUNNING OUT."

>ask marcus for help
You look at Marcus desperately.

"Marcus! Do you know the answer?! Please!"

Marcus stares at you, his face conflicted. Sweat beads on his forehead.

The monitors display: "HE KNOWS THE ANSWER. WILL HE SAVE YOU... OR HIMSELF?"

Marcus's voice trembles: "I... I do know it. I remember... from before."

He pauses, looking between you and the chamber exit door.

"But if I tell you... we both go free. If I don't..."

He's considering betraying you.

You can see the internal struggle in his eyes.

What do you say?

(Type "confess your sins" or "lie to marcus")

>confess your sins
You take a deep breath.

"Marcus... I need to tell you something."

Your voice cracks.

"In the cell... when I had to choose... I almost left you behind. I thought about saving only myself. Part of me wanted to."

Tears stream down your face.

"But I didn't. I saved you. And if I could do it again... I'd make the same choice. Because you're worth saving."

Marcus's eyes widen. His expression softens.

"You... you're telling the truth."

He steps closer.

"The answer is TRUST," he says clearly. "The thing that can be given but never taken back is TRUST."

The monitors flash GREEN.

The mechanical clamps release. You fall, catching yourself.

"CORRECT," the voice booms.

Marcus helps you down from the furniture.

"Thank you," he says quietly. "Thank you for being honest. Thank you for saving me."

The observation exit door unlocks with a heavy CLUNK.

You both survived.

>trust
That's not a verb I recognise.

>answer trust
(to the Marcus)
There is no reply.

>e
Dark Corridor
You step into a dark, narrow corridor. The walls are cold concrete, barely lit by a single flickering bulb at the far end.

Behind you, the door to the Observation Room stands open. Ahead, another door waits.

Marcus walks beside you, limping but alive.

This nightmare isn't over yet.

You can see an observation exit door, a Marcus and a jaw breaker door here.

>e
(first opening the jaw breaker door)

Marcus follows you into the room. The heavy door SLAMS shut behind you both and locks with a mechanical CLUNK.

A distorted voice crackles from hidden speakers in the ceiling.

"Welcome to your penultimate test," the voice rasps. "I've watched you both work together. I've seen trust develop between you.

How... touching.

But all good things must end."

The voice pauses dramatically.

"This game is different. This game... is not for you. This game is for Marcus."

Marcus's eyes widen in horror.

"The device above that chair is a jaw breaker. Once activated, it will slowly expand, shattering the jaw and crushing the skull.

Marcus, you will sit in that chair and wear the device. You will answer five questions. Get three wrong... and the device activates.

If Marcus refuses to play, I will release gas into this room. You will both die choking on the floor.

The choice is simple: one dies, or both die.

What will it be?"

Marcus looks at you, terrified. "There has to be another way..." he whispers.

>play yourself
"No," you say firmly. "I'll play. Not him."

"How noble," Jigsaw's voice mocks. "But I'm afraid that's not an option."

Before you can react, you hear a HISSING sound.

Gas begins pouring into the room from hidden vents in the ceiling.

Marcus screams. "NO! What did you do?!"

The gas fills your lungs. It burns. You can't breathe.

Both of you collapse to the floor, gasping, choking.

Your vision blurs. You try to crawl toward the door, but your body won't respond.

Marcus is next to you, convulsing, his face turning blue.

You can try to STRUGGLE or SHOUT, but time is running out...

>undo
Jaw Breaker Chamber
[Previous turn undone.]

>let marcus play
You look at Marcus. He's terrified, but you both know there's no other option.

"Marcus... you have to play," you say quietly.

Marcus closes his eyes. After a long moment, he nods.

"Okay. Okay, I'll do it. Better one than both."

He walks slowly to the chair and sits down. His hands are shaking as he pulls the jaw breaker device over his head.

The locks SNAP shut around his neck.

"Good," Jigsaw's voice echoes. "Let the game begin."

The first question crackles through the speakers...

QUESTION 1: What is the tallest mountain in the world?

Marcus thinks for a moment, then answers: "Mount Everest."

You hear a confirmation tone.

"CORRECT."

Marcus breathes a sigh of relief. "Okay... I can do this..."

>z
Time passes.

The second question appears:

QUESTION 2: What is the chemical symbol for water?

Marcus answers confidently: "H2O."

You hear a confirmation tone.

"CORRECT."

>z
Time passes.

The third question appears:

QUESTION 3: How many continents are there?

Marcus hesitates. "Uh... six?"

You hear an error tone.

"WRONG. The correct answer is seven."

The device tightens around Marcus's head. He gasps in pain.

"One wrong answer. Two more and the device activates."

>z
Time passes.

The fourth question appears:

QUESTION 4: What year did World War II end?

Marcus thinks carefully. "1945."

You hear a confirmation tone.

"CORRECT."

>z
Time passes.

The fifth and final question appears:

QUESTION 5: What is the smallest prime number?

Marcus's face goes pale. He's not sure.

"Um... one?" he guesses.

You hear an error tone.

"WRONG. The correct answer is two."

The device ACTIVATES.

"NO!" Marcus screams.

You watch in horror as the jaw breaker begins to expand.

Marcus's jaw is forced open wider... wider...

CRACK!

His jaw shatters. Blood pours from his mouth.

The device doesn't stop.

CRUNCH!

His skull splits open.

Marcus's body goes limp.

Press any key to continue...

>z
You're too shocked to do anything but wait.

He's dead.

You stand there, frozen in shock.

Marcus... the man who helped you survive. The man you trusted. The man you worked with to escape this nightmare.

Gone.

You feel a wave of emotions crashing over you - shock, anger, frustration, grief.

You drop to your knees, staring at his lifeless body.

"Why?" you whisper. "Why did it have to end like this?"

The silence is deafening.

>z
You're too shocked to do anything but wait.

Press any key to continue...

>z
You're too shocked to do anything but wait.

You can't move. You can't think. All you can do is stare at what's left of your companion.

The monitors flicker. Jigsaw's face appears.

"Unfortunate. But necessary. You see, Adam, this was never about him surviving. This was about YOU learning the cost of trust.

You trusted him to succeed. He failed. And now he's dead because of that trust.

Remember this lesson well."

>z
You're too shocked to do anything but wait.

Press any key to continue...

>z
You're too shocked to do anything but wait.

Adam: [shouting] "I don't give a crap if you covered yourself in peanut butter and had a 15 hooker gang bang!"

The monitors go dark.

The exit door unlocks with a heavy CLUNK.

Marcus is gone. But you can still move forward.

>e
You pause and look back one last time. Marcus's broken body lies in the jaw breaker chamber behind you.

He died because he trusted you. Or did he die because you trusted him?

The questions haunt you as you move forward.

Ahead, you see the final door. Whatever awaits you beyond... this is the end.

>e
(first opening the final entrance door)

>[enter]
You step into the control room. Monitors line the walls, surveillance equipment hums with dormant power.

In the center of the room stands a large computer terminal.

You can APPROACH the terminal or EXAMINE it.

>approach terminal
You approach the terminal. As you get closer, the screen flickers to life.

All the monitors around the room suddenly activate. Jigsaw's face appears on every screen.

"Welcome to the end, Adam. You have survived every trap, every test, every choice I set before you.

Marcus is dead. Whether by your hand or by fate, he is gone. You learned the price of trust... or the cost of betrayal.

But survival is not the same as understanding.

To leave this place, you must prove you have learned the lessons. Solve the final puzzle at the terminal.

And then... you will face one last choice.

Will you walk away... or will you seek revenge?

Choose wisely, Adam. Your life depends on it."

The screens go dark.

You can now EXAMINE the SCREEN to see the final test.

>examine screen
You lean closer to the terminal screen. Text begins to scroll across it:

FINAL TEST INITIALIZED.

I have tested your body. I have tested your mind. I have tested your morality.

Now I test your understanding.

Throughout your journey, you have encountered four key lessons: - What you gave up to survive - Who you relied on or betrayed - What you endured - The decisions that defined you

Enter the four-word code that represents these lessons. Format: WORD1 WORD2 WORD3 WORD4

Type: CODE (your answer)

Suddenly, an alarm begins to blare throughout the facility! Red lights flash.

You can now TYPE your answer into the terminal.

>CODE sacrifice trust pain choice
The terminal screen flashes GREEN.

"CORRECT. YOU HAVE LEARNED THE LESSONS."

You hear heavy locks disengaging. Both doors - north and south - unlock simultaneously.

The terminal displays your final choice:

"FREEDOM lies to the NORTH. Walk away. Survive. Live with your scars.

REVENGE lies to the SOUTH. Confront me. Kill me. Die with me.

The choice is yours, Adam. I will not stop you either way.

What kind of person will you be?"

>n
You stand before the green door marked FREEDOM.

Marcus's face flashes in your mind. His death. His trust. His betrayal. His sacrifice.

You reach for the door handle...

...and pull it open.

Beyond the door is a staircase leading up. You can see daylight filtering down from above.

Fresh air. Freedom. Life.

The weight of the nightmare begins to lift from your shoulders.

(Press Z to continue)
(first opening the freedom door)

You climb the stairs, leaving the nightmare behind.

---

You emerge into an abandoned warehouse district. The sun is setting. You're covered in blood, missing parts of yourself, but you're ALIVE.

You hear sirens in the distance. Help is coming.

Marcus didn't make it. That weight will stay with you forever.

But you survived.

Jigsaw is still out there. Still killing. Still testing.

But you're free.

(Press Z to continue)

>undo
Control Room
[Previous turn undone.]

>s
Marcus's face burns in your mind. His screams. His death. His trust that you FAILED.

You chose revenge.

You pull open the red door and step through.

(first opening the revenge door)

He speaks, his voice barely a whisper:

"You came for revenge. I expected nothing less. Marcus's death weighs on you. Good. It should.

But before you kill me, know this: I am already dying. Cancer. Inoperable. I have weeks, maybe days left.

You can end my suffering early. But this facility... it's rigged to explode if my heart stops. A failsafe.

Kill me, and we both die. You'll have your revenge, but you'll never see daylight again.

Or... you can walk away. Let me die slowly, painfully, as I deserve. And you live.

The choice, Adam, is yours."

You can KILL JIGSAW or LEAVE.

>kill jigsaw
"This is for Marcus," you snarl through clenched teeth.

Your hands close around his frail throat with brutal force.

He doesn't resist. He simply watches you with those calm, knowing eyes - even now, in control.

That infuriates you MORE.

You SQUEEZE. Hard. Your fingers dig deep into his flesh, crushing his windpipe.

His eyes bulge. His face turns purple. Blood vessels burst in his eyes.

His body convulses, tubes ripping from his arms. Medical monitors SHRIEK in alarm.

You don't let go. You squeeze HARDER.

His breathing becomes desperate, wet, gurgling... then stops.

His body goes limp.

His heart stops beating.

For a moment, there is only silence.

The monster is dead. By YOUR hands.

Marcus is avenged.

(Press Z to continue)

>z
Time passes.

Then...

A compartment in the wall suddenly slides open with a mechanical CLICK.

A small figure emerges on a mechanical track - a miniature PUPPET on a tricycle, dressed like Jigsaw.

Its eyes glow red. Its mouth opens...

"HAHAHAHAHA! I WANT TO PLAY A GAME!"

"HAHAHAHAHA! I WANT TO PLAY A GAME!"

The mechanical laugh echoes through the room.

(Press Z to continue)

>z
Time passes.

"Congratulations, Adam. You killed me. But did you really think... it would be that SIMPLE?

This facility is rigged with EXPLOSIVES. The moment my heart stopped... you triggered the failsafe.

I told you what would happen. You CHOSE this.

Welcome to your GRAVE!"

BEEEEEEEEP.

An alarm blares throughout the facility. Red lights flash.

A computerized voice echoes: "HEART RATE ZERO DETECTED. SELF-DESTRUCT SEQUENCE ACTIVATED. DETONATION IN 10 SECONDS."

10... 9... 8...

You run for the door, but it SLAMS shut and locks.

7... 6... 5...

There is no escape.

4... 3... 2...

You'll see Marcus soon.

1...

BOOM.

(Press Z to continue)

>z
Time passes.

>z
Time passes.

The entire facility explodes in a massive fireball.

You and Jigsaw die together in the flames.

(Press Z to continue)

>z
Time passes.

THE END

(You chose REVENGE over SURVIVAL)
Marcus has been avenged but at the cost of your own life.

    *** The End ***

Would you like to RESTART, RESTORE a saved game, QUIT or UNDO the last command?

* * *

>HELP
> Introduction to Saw Escape Room
   Instructions for Play
   Commands
   About

>q
Cell
You wake up strapped to a rusted metal bed in a filthy concrete cell. A heavy iron shackle locks your ankle in place, connected by a thick chain to another body nearby. Dark stains cover the floor beneath you, old and dried. The air reeks of metal, mold, and something far worse.

There are no windows. No mercy. Only waiting.

You can see:
- The unconscious man chained beside you
- The heavy iron chain binding you both
- A glowing button on the wall

>About
> Introduction to Saw Escape Room
   Instructions for Play
   Commands
   About

>q
Cell
You wake up strapped to a rusted metal bed in a filthy concrete cell. A heavy iron shackle locks your ankle in place, connected by a thick chain to another body nearby. Dark stains cover the floor beneath you, old and dried. The air reeks of metal, mold, and something far worse.

There are no windows. No mercy. Only waiting.

You can see:
- The unconscious man chained beside you
- The heavy iron chain binding you both
- A glowing button on the wall

>help
> Introduction to Saw Escape Room
   Instructions for Play
   Commands
   About

>n
Introduction to Saw Escape Room
 > Instructions for Play
   Commands
   About

   Introduction to Saw Escape Room
 > Instructions for Play
   Commands
   About

>[enter]
> About Interactive Fiction
   What to do with >
   Getting Started
   Rooms and Travel
   Objects
   Controlling the Game
   How the World is Assembled
   If You Get Stuck

>n
About Interactive Fiction
 > What to do with >
   Getting Started
   Rooms and Travel
   Objects
   Controlling the Game
   How the World is Assembled
   If You Get Stuck

   About Interactive Fiction
 > What to do with >
   Getting Started
   Rooms and Travel
   Objects
   Controlling the Game
   How the World is Assembled
   If You Get Stuck

>[enter]
The > sign is where the game says, "Okay, what do you want to do now?"  You may respond by typing an instruction -- usually an imperative verb, possibly followed by prepositions and objects.  So, for instance, LOOK, LOOK AT FISH, TAKE FISH.

Please press SPACE to continue.

* * *

About Interactive Fiction
 > What to do with >
   Getting Started
   Rooms and Travel
   Objects
   Controlling the Game
   How the World is Assembled
   If You Get Stuck

   About Interactive Fiction
 > What to do with >
   Getting Started
   Rooms and Travel
   Objects
   Controlling the Game
   How the World is Assembled
   If You Get Stuck

The > sign is where the game says, "Okay, what do you want to do now?"  You may respond by typing an instruction -- usually an imperative verb, possibly followed by prepositions and objects.  So, for instance, LOOK, LOOK AT FISH, TAKE FISH.

Please press SPACE to continue.

About Interactive Fiction
 > What to do with >
   Getting Started
   Rooms and Travel
   Objects
   Controlling the Game
   How the World is Assembled
   If You Get Stuck

   About Interactive Fiction
 > What to do with >
   Getting Started
   Rooms and Travel
   Objects
   Controlling the Game
   How the World is Assembled
   If You Get Stuck

>q
Introduction to Saw Escape Room
 > Instructions for Play
   Commands
   About

>[enter]
> About Interactive Fiction
   What to do with >
   Getting Started
   Rooms and Travel
   Objects
   Controlling the Game
   How the World is Assembled
   If You Get Stuck

>q
Introduction to Saw Escape Room
 > Instructions for Play
   Commands
   About

>q
Cell
You wake up strapped to a rusted metal bed in a filthy concrete cell. A heavy iron shackle locks your ankle in place, connected by a thick chain to another body nearby. Dark stains cover the floor beneath you, old and dried. The air reeks of metal, mold, and something far worse.

There are no windows. No mercy. Only waiting.

You can see:
- The unconscious man chained beside you
- The heavy iron chain binding you both
- A glowing button on the wall

>reload
That's not a verb I recognise.

>QUIT
Are you sure you want to quit?

* * *

>TELL ALAN ABOUT INCREMENT
Alan's gears whir as he configures the machine.
"INCREMENT program loaded," he announces. "This adds 1 to binary numbers."
"TELL me ABOUT INPUT, then SAY binary digits TO me."

I beg your pardon?

>TELL ALAN ABOUT INPUT
Alan clears the tape with a sweeping gesture.
"Ready for input," he announces. "SAY binary digits (0 or 1) TO me."
"SAY DONE TO me when finished."

>SAY 1 TO ALAN
Alan carefully writes "1" on the tape.
"Tape: [1]______________" he reports. "SAY more digits or DONE."

>SAY 0 TO ALAN
Alan carefully writes "0" on the tape.
"Tape: [1]0_____________" he reports. "SAY more digits or DONE."

>SAY 1 TO ALAN
Alan carefully writes "1" on the tape.
"Tape: [1]01____________" he reports. "SAY more digits or DONE."

>SAY 1 TO ALAN
Alan carefully writes "1" on the tape.
"Tape: [1]011___________" he reports. "SAY more digits or DONE."

>SAY RUN TO ALAN
Alan begins operating the machine rapidly...
Step 0: State=q0, Tape=[1]011___________
Step 1: State=q0, Tape=1[0]11___________
Step 2: State=q0, Tape=10[1]1___________
Step 3: State=q0, Tape=101[1]___________
Step 4: State=q0, Tape=1011[_]__________
Step 5: State=q1, Tape=101[1]___________
Step 6: State=q1, Tape=10[1]0___________
Step 7: State=q1, Tape=1[0]00___________

Alan announces: "========================================"
"Result: HALTED," Alan reports.
"Final tape: 1[1]00___________"
"Total steps: 8"

>TELL ALAN ABOUT INCREMENT
Alan nods: "INCREMENT program already loaded."

>TELL ALAN ABOUT INPUT
Alan clears the tape with a sweeping gesture.
"Ready for input," he announces. "SAY binary digits (0 or 1) TO me."
"SAY DONE TO me when finished."

* * *

>SAY 1 TO ALAN
Alan carefully writes "1" on the tape.
"Tape: [1]______________" he reports. "SAY more digits or DONE."

>SAY 1 TO ALAN
Alan carefully writes "1" on the tape.
"Tape: [1]1_____________" he reports. "SAY more digits or DONE."

>SAY 1 TO ALAN
Alan carefully writes "1" on the tape.
"Tape: [1]11____________" he reports. "SAY more digits or DONE."

>SAY RUN TO ALAN
Alan begins operating the machine rapidly...
Step 0: State=q0, Tape=[1]11____________
Step 1: State=q0, Tape=1[1]1____________
Step 2: State=q0, Tape=11[1]____________
Step 3: State=q0, Tape=111[_]___________
Step 4: State=q1, Tape=11[1]____________
Step 5: State=q1, Tape=1[1]0____________
Step 6: State=q1, Tape=[1]00____________
Step 7: State=q1, Tape=[_]000____________

Alan announces: "========================================"
"Result: HALTED," Alan reports.
"Final tape: [1]000____________"
"Total steps: 8"

>TELL ALAN ABOUT INCREMENT
Alan nods: "INCREMENT program already loaded."

* * *

>TELL ALAN ABOUT INPUT
Alan clears the tape with a sweeping gesture.
"Ready for input," he announces. "SAY binary digits (0 or 1) TO me."
"SAY DONE TO me when finished."

>SAY 0 TO ALAN
Alan carefully writes "0" on the tape.
"Tape: [0]______________" he reports. "SAY more digits or DONE."

>SAY RUN TO ALAN
Alan begins operating the machine rapidly...
Step 0: State=q0, Tape=[0]______________
Step 1: State=q0, Tape=0[_]_____________
Step 2: State=q1, Tape=[0]______________

Alan announces: "========================================"
"Result: HALTED," Alan reports.
"Final tape: [1]______________"
"Total steps: 3"

>TELL ALAN ABOUT INCREMENT
Alan nods: "INCREMENT program already loaded."

* * *

>SAY 1 TO ALAN
Alan carefully writes "1" on the tape.
"Tape: [1]1_____________" he reports. "SAY more digits or DONE."

>SAY STEP TO ALAN
Alan performs one computation step...
Step 0: State=q0, Tape=[1]1_____________
Alan reports: "State=q0, Tape=1[1]_____________"

I beg your pardon?

I beg your pardon?

>TELL ALAN ABOUT INCREMENT
Alan nods: "INCREMENT program already loaded."

* * *

>SAY 1 TO ALAN
Alan carefully writes "1" on the tape.
"Tape: [1]011___________" he reports. "SAY more digits or DONE."

>RUN TO ALAN
You can't see any such thing.

>SAY RUN TO ALAN
Alan begins operating the machine rapidly...
Step 0: State=q0, Tape=[1]011___________
Step 1: State=q0, Tape=1[0]11___________
Step 2: State=q0, Tape=10[1]1___________
Step 3: State=q0, Tape=101[1]___________
Step 4: State=q0, Tape=1011[_]__________
Step 5: State=q1, Tape=101[1]___________
Step 6: State=q1, Tape=10[1]0___________
Step 7: State=q1, Tape=1[0]00___________

Alan announces: "========================================"
"Result: HALTED," Alan reports.
"Final tape: 1[1]00___________"
"Total steps: 8"

* * *

>SAY STEP TO ALAN
Alan performs one computation step...
Step 0: State=q0, Tape=[1]1_____________
Alan reports: "State=q0, Tape=1[1]_____________"

>SAY STEP TO ALAN
Alan performs one computation step...
Step 1: State=q0, Tape=1[1]_____________
Alan reports: "State=q0, Tape=11[_]____________"

>SAY STEP TO ALAN
Alan performs one computation step...
Step 2: State=q0, Tape=11[_]____________
Alan reports: "State=q1, Tape=1[1]_____________"

>SAY STEP TO ALAN
Alan performs one computation step...
Step 3: State=q1, Tape=1[1]_____________
Alan reports: "State=q1, Tape=[1]0_____________"

>SAY STEP TO ALAN
Alan performs one computation step...
Step 4: State=q1, Tape=[1]0_____________
Alan reports: "State=q1, Tape=[_]00_____________"

>SAY STEP TO ALAN
Alan performs one computation step...
Step 5: State=q1, Tape=[_]00_____________

Alan announces: "*** HALTED in state: halt ***"
"Final tape: [1]00_____________"

>TELL ALAN ABOUT PALINDROME
Alan adjusts the control unit carefully.
"PALINDROME program loaded," he states. "This checks for symmetry."
"Result will be ACCEPT or REJECT."

>TELL ALAN ABOUT INPUT
Alan clears the tape with a sweeping gesture.
"Ready for input," he announces. "SAY binary digits (0 or 1) TO me."
"SAY DONE TO me when finished."

* * *

>SAY 1 TO ALAN
Alan carefully writes "1" on the tape.
"Tape: [1]01____________" he reports. "SAY more digits or DONE."

>SAY RUN TO ALAN
Alan begins operating the machine rapidly...
Step 0: State=q0, Tape=[1]01____________
Step 1: State=find1, Tape=_[0]1____________
Step 2: State=find1, Tape=_0[1]____________
Step 3: State=find1, Tape=_01[_]___________
Step 4: State=check1, Tape=_0[1]____________
Step 5: State=return, Tape=_[0]_____________
Step 6: State=return, Tape=[_]0_____________
Step 7: State=q0, Tape=_[0]_____________
Step 8: State=find0, Tape=__[_]____________
Step 9: State=check0, Tape=_[_]_____________

Alan announces: "========================================"
"Result: ACCEPT," Alan declares proudly.
"Final tape: _[_]_____________"
"Total steps: 10"

>TELL ALAN ABOUT PALINDROME
Alan nods: "PALINDROME program already loaded."

>TELL ALAN ABOUT INPUT
Alan clears the tape with a sweeping gesture.
"Ready for input," he announces. "SAY binary digits (0 or 1) TO me."
"SAY DONE TO me when finished."

* * *

>SAY 1 TO ALAN
Alan carefully writes "1" on the tape.
"Tape: [1]011___________" he reports. "SAY more digits or DONE."

>SAY RUN TO ALAN
Alan begins operating the machine rapidly...
Step 0: State=q0, Tape=[1]011___________
Step 1: State=find1, Tape=_[0]11___________
Step 2: State=find1, Tape=_0[1]1___________
Step 3: State=find1, Tape=_01[1]___________
Step 4: State=find1, Tape=_011[_]__________
Step 5: State=check1, Tape=_01[1]___________
Step 6: State=return, Tape=_0[1]____________
Step 7: State=return, Tape=_[0]1____________
Step 8: State=return, Tape=[_]01____________
Step 9: State=q0, Tape=_[0]1____________
Step 10: State=find0, Tape=__[1]____________
Step 11: State=find0, Tape=__1[_]___________
Step 12: State=check0, Tape=__[1]____________

Alan announces: "========================================"
"Result: REJECT," Alan states matter-of-factly.
"Final tape: __[1]____________"
"Total steps: 13"

>TELL ALAN ABOUT PALINDROME
Alan nods: "PALINDROME program already loaded."

* * *

>SAY 1 TO ALAN
Alan carefully writes "1" on the tape.
"Tape: [1]______________" he reports. "SAY more digits or DONE."

>SAY RUN TO ALAN
Alan begins operating the machine rapidly...
Step 0: State=q0, Tape=[1]______________
Step 1: State=find1, Tape=_[_]_____________
Step 2: State=check1, Tape=[_]______________

Alan announces: "========================================"
"Result: ACCEPT," Alan declares proudly.
"Final tape: [_]______________"
"Total steps: 3"

>TELL ALAN ABOUT EVEN
Alan reconfigures the transition table.
"EVEN program loaded," he reports. "This counts ones."
"Result will be ACCEPT (even) or REJECT (odd)."

>TELL ALAN ABOUT INPUT
Alan clears the tape with a sweeping gesture.
"Ready for input," he announces. "SAY binary digits (0 or 1) TO me."
"SAY DONE TO me when finished."

* * *

>SAY 1 TO ALAN
Alan carefully writes "1" on the tape.
"Tape: [1]1_____________" he reports. "SAY more digits or DONE."

>SAY 0 TO ALAN
Alan carefully writes "0" on the tape.
"Tape: [1]10____________" he reports. "SAY more digits or DONE."

>SAY 0 TO ALAN
Alan carefully writes "0" on the tape.
"Tape: [1]100___________" he reports. "SAY more digits or DONE."

>SAY RUN TO ALAN
Alan begins operating the machine rapidly...
Step 0: State=even, Tape=[1]100___________
Step 1: State=odd, Tape=1[1]00___________
Step 2: State=even, Tape=11[0]0___________
Step 3: State=even, Tape=110[0]___________
Step 4: State=even, Tape=1100[_]__________

Alan announces: "========================================"
"Result: ACCEPT," Alan declares proudly.
"Final tape: 1100[_]__________"
"Total steps: 5"

>TELL ALAN ABOUT EVEN
Alan nods: "EVEN program already loaded."

>TELL ALAN ABOUT INPUT
Alan clears the tape with a sweeping gesture.
"Ready for input," he announces. "SAY binary digits (0 or 1) TO me."
"SAY DONE TO me when finished."

* * *

>SAY 1 TO ALAN
Alan carefully writes "1" on the tape.
"Tape: [1]11____________" he reports. "SAY more digits or DONE."

>SAY RUN TO ALAN
Alan begins operating the machine rapidly...
Step 0: State=even, Tape=[1]11____________
Step 1: State=odd, Tape=1[1]1____________
Step 2: State=even, Tape=11[1]____________
Step 3: State=odd, Tape=111[_]___________

Alan announces: "========================================"
"Result: REJECT," Alan states matter-of-factly.
"Final tape: 111[_]___________"
"Total steps: 4"

>TELL ALAN ABOUT EVEN
Alan nods: "EVEN program already loaded."

* * *

>SAY 0 TO ALAN
Alan carefully writes "0" on the tape.
"Tape: [0]______________" he reports. "SAY more digits or DONE."

>SAY 0 TO ALAN
Alan carefully writes "0" on the tape.
"Tape: [0]0_____________" he reports. "SAY more digits or DONE."

>SAY 0 TO ALAN
Alan carefully writes "0" on the tape.
"Tape: [0]00____________" he reports. "SAY more digits or DONE."

>SAY 0 TO ALAN
Alan carefully writes "0" on the tape.
"Tape: [0]000___________" he reports. "SAY more digits or DONE."

>SAY RUN TO ALAN
Alan begins operating the machine rapidly...
Step 0: State=even, Tape=[0]000___________
Step 1: State=even, Tape=0[0]00___________
Step 2: State=even, Tape=00[0]0___________
Step 3: State=even, Tape=000[0]___________
Step 4: State=even, Tape=0000[_]__________

Alan announces: "========================================"
"Result: ACCEPT," Alan declares proudly.
"Final tape: 0000[_]__________"
"Total steps: 5"

>TELL ALAN ABOUT INCREMENT
Alan's gears whir as he configures the machine.
"INCREMENT program loaded," he announces. "This adds 1 to binary numbers."
"TELL me ABOUT INPUT, then SAY binary digits TO me."

>TELL ALAN ABOUT INPUT
Alan clears the tape with a sweeping gesture.
"Ready for input," he announces. "SAY binary digits (0 or 1) TO me."
"SAY DONE TO me when finished."

* * *

>SAY 0 TO ALAN
Alan carefully writes "0" on the tape.
"Tape: [1]0_____________" he reports. "SAY more digits or DONE."

>SAY STEP TO ALAN
Alan performs one computation step...
Step 0: State=q0, Tape=[1]0_____________
Alan reports: "State=q0, Tape=1[0]_____________"

>SAY STEP TO ALAN
Alan performs one computation step...
Step 1: State=q0, Tape=1[0]_____________
Alan reports: "State=q0, Tape=10[_]____________"

>SAY RESET TO ALAN
Alan methodically resets the machine.
"Machine reset. Tape cleared, state initialized," he confirms.

>ASK ALAN ABOUT STATE
Alan recites mechanically:
"Program: increment
State: q0
Step: 0
Halted: false"
"Tape: [_]______________"

* * *

>TELL ALAN ABOUT INPUT
Alan clears the tape with a sweeping gesture.
"Ready for input," he announces. "SAY binary digits (0 or 1) TO me."
"SAY DONE TO me when finished."

>SAY '1' TO ALAN
There is no reply.

>SAY '0' TO ALAN
There is no reply.

>SAY '1' TO ALAN
There is no reply.

>SAY '1' TO ALAN
There is no reply.

>SAY 'RUN' TO ALAN
There is no reply.

* * *

>check chain
The heavy iron chain binds you to the other prisoner. Each of you wears a tight ankle shackle, far too small to slip free.

The chain passes through an iron bar embedded in the wall. There is no way to pull a body through it. This was engineered with precision.

>check button
A circular metal button embedded in the wall beside you. It pulses faintly, as if aware of your hesitation.

The glowing button is currently switched off.

>press button
You press the button.

A section of the far wall collapses, revealing a heavy metal door.

A rusty hand saw falls from the ceiling, landing between you and the unconscious man.

Hidden machinery roars to life inside the walls.
The ceiling shudders - then begins to descend.

The ceiling grinds lower, showering you with dust and fragments of concrete.

* * *

>take saw
Taken.

The ceiling grinds lower, showering you with dust and fragments of concrete.

>i
You are carrying:
  a hand saw

The ceiling grinds lower, showering you with dust and fragments of concrete.

>undo
Cell
[Previous turn undone.]

>saw chain
You press the blade against the thick iron chain and start sawing desperately.

The metal barely scratches.

The chain is far too thick. There isn't enough time.

The ceiling grinds lower, showering you with dust and fragments of concrete.

>saw leg
(of the man)
You saw through his ankle. His body jerks violently, but he remains unconscious. The chain finally drops.

The ceiling grinds lower, showering you with dust and fragments of concrete.

>n
You throw yourself through the doorway as the ceiling crashes down behind you.
You survived - at a terrible cost.

(first opening the cell exit door)

Exit Hall
A narrow concrete corridor stretches into darkness. The air is colder here, heavier. Whatever comes next, you have left the cell behind.

To the north, you can see a heavy metal door marked with biohazard symbols. Behind it, you hear the faint hum of fluorescent lights.

>undo
Cell
[Previous turn undone.]

>save man
You grab him under the arms and begin dragging his limp body. Every second counts.

The ceiling grinds lower, showering you with dust and fragments of concrete.

>i
You are carrying:
  a hand saw

The ceiling comes down with terrible finality.
There is no escape.

Everything goes black.

*** Press any key to continue ***

>undo
Cell
[Previous turn undone.]

>n
You throw yourself through the doorway, dragging him with you, as the ceiling crashes down behind you.
You both survived - at a terrible cost.

(first opening the cell exit door)

Exit Hall
A narrow concrete corridor stretches into darkness. The air is colder here, heavier. Whatever comes next, you have left the cell behind.

To the north, you can see a heavy metal door marked with biohazard symbols. Behind it, you hear the faint hum of fluorescent lights.

Marcus lies unconscious on the cold concrete floor, his bandaged ankle still seeping blood.

I beg your pardon?

>n
As you enter the chamber, you notice The man's severed ankle is bleeding heavily. Blood pools beneath him, spreading across the floor. You need to do something quickly, or he won't make it.

Blood continues to pour from The man's wound. His breathing becomes more labored.

* * *

>take gauze
Taken.

The man's breathing is barely detectable. He's losing too much blood!

>take tape
Taken.

The man's body is going into shock. His pulse is fading. This is his last chance!

>undo
Medical Chamber
[Previous turn undone.]

>check cabinet
An open medical cabinet containing various supplies: - Surgical tape

In the open cabinet is a medical tape.

The man's body is going into shock. His pulse is fading. This is his last chance!

>undo
Medical Chamber
[Previous turn undone.]

>i
You are carrying:
  a medical gauze
  a hand saw

The man's body is going into shock. His pulse is fading. This is his last chance!

* * *

>check chain
The heavy iron chain binds you to the other prisoner. Each of you wears a tight ankle shackle, far too small to slip free.

The chain passes through an iron bar embedded in the wall. There is no way to pull a body through it. This was engineered with precision.

>check man
A man is chained beside you, his body limp and unnaturally still. His head hangs to one side. His breathing is shallow, barely noticeable.

>shake man
You grab his shoulder and shake him hard. His body reacts, but his eyes never open.

Whatever they injected into him has left him completely helpless.

>check button
A circular metal button embedded in the wall beside you. It pulses faintly, as if aware of your hesitation.

The glowing button is currently switched off.

>check if man is alive
You force yourself to watch his chest. After several agonizing seconds, it rises slightly. He is alive.

>press button
You press the button.

A section of the far wall collapses, revealing a heavy metal door.

A rusty hand saw falls from the ceiling, landing between you and the unconscious man.

Hidden machinery roars to life inside the walls.
The ceiling shudders - then begins to descend.

The ceiling grinds lower, showering you with dust and fragments of concrete.

* * *

>take saw
Taken.

The ceiling grinds lower, showering you with dust and fragments of concrete.

>check man
A man is chained beside you, his body limp and unnaturally still. His head hangs to one side. His breathing is shallow, barely noticeable.

The ceiling grinds lower, showering you with dust and fragments of concrete.

>shake man
You grab his shoulder and shake him hard. His body reacts, but his eyes never open.

Whatever they injected into him has left him completely helpless.

The ceiling comes down with terrible finality.
There is no escape.

Everything goes black.

    *** The End ***

Would you like to RESTART, RESTORE a saved game, QUIT or UNDO the last command?

>restart
You regain consciousness to the sound of chains and distant machinery.

A distorted voice fills the room.

Saw Escape Room
An Interactive Fiction by Marko Sokser
Release 1 / Serial number 251212 / Inform 7 v10.1.2 / D

Cell
You wake up strapped to a rusted metal bed in a filthy concrete cell. A heavy iron shackle locks your ankle in place, connected by a thick chain to another body nearby. Dark stains cover the floor beneath you, old and dried. The air reeks of metal, mold, and something far worse.

There are no windows. No mercy. Only waiting.

>press button
You press the button.

A section of the far wall collapses, revealing a heavy metal door.

A rusty hand saw falls from the ceiling, landing between you and the unconscious man.

Hidden machinery roars to life inside the walls.
The ceiling shudders - then begins to descend.

The ceiling grinds lower, showering you with dust and fragments of concrete.

* * *

>take saw
Taken.

The ceiling grinds lower, showering you with dust and fragments of concrete.

>saw man
You saw through his ankle. His body jerks violently, but he remains unconscious. The chain finally drops.

The ceiling grinds lower, showering you with dust and fragments of concrete.

>n
You throw yourself through the doorway as the ceiling crashes down behind you.
You survived - at a terrible cost.

(first opening the exit door)

Exit Hall
A narrow concrete corridor stretches into darkness. The air is colder here, heavier. Whatever comes next, you have left the cell behind.

You can see an exit door here.

* * *

>check man
A man is chained beside you, his body limp and unnaturally still. His head hangs to one side. His breathing is shallow, barely noticeable.

>shake man
You grab his shoulder and shake him hard. His body reacts, but his eyes never open. Whatever they injected into him has left him completely helpless.

>check chain
The heavy iron chain binds you to the other prisoner. Each of you wears a tight ankle shackle, far too small to slip free.

The chain passes through an iron bar embedded in the wall. There is no way to pull a body through it. This was engineered with precision.

>n
The wall is solid concrete. There is no exit there. Its not like this chain will let you

>e
You can't go that way.

>w
You can't go that way.

>s
You can't go that way.

>check button
A circular metal button embedded in the wall beside you. It pulses faintly, as if aware of your hesitation.

The glowing button is currently switched off.

>i
You are carrying nothing.

>press button
You press the button.

A section of the far wall collapses, revealing a heavy metal door.

A rusty hand saw falls from the ceiling, landing between you and the unconscious man.

Hidden machinery roars to life inside the walls.
The ceiling shudders - then begins to descend.

The ceiling grinds lower, showering you with dust and fragments of concrete.

* * *

>take saw
Taken.

The ceiling grinds lower, showering you with dust and fragments of concrete.

>cut chain
You press the blade against the thick iron chain and start sawing desperately.

The metal barely scratches.

The chain is far too thick. There isn't enough time.

The ceiling grinds lower, showering you with dust and fragments of concrete.

>cut man
That's not something you can cut.

The ceiling grinds lower, showering you with dust and fragments of concrete.

>saw man
That's not something you can cut.

The ceiling grinds lower, showering you with dust and fragments of concrete.

>cut man
That's not something you can cut.

The ceiling comes down with terrible finality.
There is no escape.

Everything goes black.

*** Press any key to continue ***

* * *

>help
TURING MACHINE SIMULATOR - COMMANDS
======================================

LOAD INCREMENT  - Load binary increment program
LOAD PALINDROME - Load palindrome checker
LOAD EVEN       - Load even ones checker

INPUT <text>    - Set the tape input (e.g., INPUT 1011)
STEP            - Execute one step
EXECUTE         - Run until machine halts
EXAMINE TAPE    - Show current tape state
EXAMINE STATE   - Show machine state
RESET           - Reset the machine
HELP            - Show this help

>[down]
Introduction to Saw Escape Room
 > Instructions for Play
   Commands
   About

   Introduction to Saw Escape Room
 > Instructions for Play
   Commands
   About

>[up]
> Introduction to Saw Escape Room
   Instructions for Play
   Commands
   About

 > Introduction to Saw Escape Room
   Instructions for Play
   Commands
   About

* * *

>[down]
Introduction to Saw Escape Room
   Instructions for Play
 > Commands
   About

   Introduction to Saw Escape Room
   Instructions for Play
 > Commands
   About

>[down]
Introduction to Saw Escape Room
   Instructions for Play
   Commands
 > About

   Introduction to Saw Escape Room
   Instructions for Play
   Commands
 > About

>[enter]
About this game

Please press SPACE to continue.

* * *

Introduction to Saw Escape Room
   Instructions for Play
   Commands
 > About

   Introduction to Saw Escape Room
   Instructions for Play
   Commands
 > About

>[up]
Introduction to Saw Escape Room
   Instructions for Play
 > Commands
   About

   Introduction to Saw Escape Room
   Instructions for Play
 > Commands
   About

>[enter]
> Movement
   Interaction
   Special Commands
   Tips

>[enter]
Use N, S, E, W (or NORTH, SOUTH, EAST, WEST) to move between rooms.

Please press SPACE to continue.

> Movement
   Interaction
   Special Commands
   Tips

 > Movement
   Interaction
   Special Commands
   Tips

>[down]
Movement
 > Interaction
   Special Commands
   Tips

   Movement
 > Interaction
   Special Commands
   Tips

>[enter]
LOOK or L - Look around
EXAMINE (object) or X (object) - Examine something
TAKE (object) - Pick up an object
USE (object) - Use an object
INVENTORY or I - Check what you're carrying

Please press SPACE to continue.

* * *

Movement
 > Interaction
   Special Commands
   Tips

   Movement
 > Interaction
   Special Commands
   Tips

>[down]
Movement
   Interaction
 > Special Commands
   Tips

   Movement
   Interaction
 > Special Commands
   Tips

>[enter]
SAW LEG - Cut your leg (Cell)
STEP ON (color) PLATE - Medical Chamber puzzle
BANDAGE MYSELF/MARCUS - Stop bleeding
RESPOND (answer) - Answer questions
APPROACH TERMINAL - Control Room
EXAMINE SCREEN - View final puzzle
CODE (text) - Enter terminal code
KILL JIGSAW - Attack Jigsaw
LEAVE - Exit scene

Please press SPACE to continue.

* * *

Movement
   Interaction
 > Special Commands
   Tips

   Movement
   Interaction
 > Special Commands
   Tips

>[down]
Movement
   Interaction
   Special Commands
 > Tips

   Movement
   Interaction
   Special Commands
 > Tips

>[enter]
Read all descriptions carefully
Some puzzles have limited attempts
Your choices affect the ending
Type WAIT or Z to skip a turn

Please press SPACE to continue.

Movement
   Interaction
   Special Commands
 > Tips

   Movement
   Interaction
   Special Commands
 > Tips

>[up]
Movement
   Interaction
 > Special Commands
   Tips

   Movement
   Interaction
 > Special Commands
   Tips

>p
Movement
 > Interaction
   Special Commands
   Tips

   Movement
 > Interaction
   Special Commands
   Tips

>q
Introduction to Saw Escape Room
   Instructions for Play
 > Commands
   About

>[up]
Introduction to Saw Escape Room
 > Instructions for Play
   Commands
   About

   Introduction to Saw Escape Room
 > Instructions for Play
   Commands
   About

>[enter]
> About Interactive Fiction
   What to do with >
   Getting Started
   Rooms and Travel
   Objects
   Controlling the Game
   How the World is Assembled
   If You Get Stuck

>[enter]
The game you are playing is a work of Interactive Fiction.  In interactive fiction you play the main character of a story.  You type commands which determine the actions of the character and the flow of the plot.  Some IF games include graphics, but most do not: the imagery is provided courtesy of your imagination.  On the other hand, there's a wide range of action available: whereas in other games you may be restricted to shooting, movement, or searching items you can click on with a mouse, IF allows you a wide range of verbs.

Please press SPACE to continue.

> About Interactive Fiction
   What to do with >
   Getting Started
   Rooms and Travel
   Objects
   Controlling the Game
   How the World is Assembled
   If You Get Stuck

 > About Interactive Fiction
   What to do with >
   Getting Started
   Rooms and Travel
   Objects
   Controlling the Game
   How the World is Assembled
   If You Get Stuck

>[down]
About Interactive Fiction
 > What to do with >
   Getting Started
   Rooms and Travel
   Objects
   Controlling the Game
   How the World is Assembled
   If You Get Stuck

   About Interactive Fiction
 > What to do with >
   Getting Started
   Rooms and Travel
   Objects
   Controlling the Game
   How the World is Assembled
   If You Get Stuck

>[enter]
The > sign is where the game says, "Okay, what do you want to do now?"  You may respond by typing an instruction -- usually an imperative verb, possibly followed by prepositions and objects.  So, for instance, LOOK, LOOK AT FISH, TAKE FISH.

Please press SPACE to continue.

About Interactive Fiction
 > What to do with >
   Getting Started
   Rooms and Travel
   Objects
   Controlling the Game
   How the World is Assembled
   If You Get Stuck

   About Interactive Fiction
 > What to do with >
   Getting Started
   Rooms and Travel
   Objects
   Controlling the Game
   How the World is Assembled
   If You Get Stuck

>[down]
About Interactive Fiction
   What to do with >
 > Getting Started
   Rooms and Travel
   Objects
   Controlling the Game
   How the World is Assembled
   If You Get Stuck

   About Interactive Fiction
   What to do with >
 > Getting Started
   Rooms and Travel
   Objects
   Controlling the Game
   How the World is Assembled
   If You Get Stuck

>[enter]
The first thing you want to do when starting a game is acquaint yourself with your surroundings and get a sense of your goal. To this end, you should read the introductory text carefully. Sometimes it contains clues. You will also want to look at the room you are in. Notice where the exits from the room are, and what objects are described here. If any of these seem interesting, you may want to EXAMINE them. 

You might also want to examine yourself (EXAMINE ME) to see whether the author has left you any clues about your character. TAKE INVENTORY will tell you what you're carrying, as well.

Once you've gotten your bearings, you may want to explore. Move from room to room, and check out every location available.

Please press SPACE to continue.

About Interactive Fiction
   What to do with >
 > Getting Started
   Rooms and Travel
   Objects
   Controlling the Game
   How the World is Assembled
   If You Get Stuck

   About Interactive Fiction
   What to do with >
 > Getting Started
   Rooms and Travel
   Objects
   Controlling the Game
   How the World is Assembled
   If You Get Stuck

>[down]
About Interactive Fiction
   What to do with >
   Getting Started
 > Rooms and Travel
   Objects
   Controlling the Game
   How the World is Assembled
   If You Get Stuck

   About Interactive Fiction
   What to do with >
   Getting Started
 > Rooms and Travel
   Objects
   Controlling the Game
   How the World is Assembled
   If You Get Stuck

>[enter]
At any given time, you are in a specific location, or room. When you go into a room, the game will print a description of what you can see there. This description will contain two vital kinds of information: things in the room you can interact with or take, and a list of exits, or ways out. If you want to see the description again, you may just type LOOK. 

When you want to leave a location and go to another one, you may communicate this to the game using compass directions: eg, GO NORTH. For simplicity's sake, you are allowed to omit the word GO, and to abbreviate the compass directions. So you may use NORTH, SOUTH, EAST, WEST, NORTHEAST, SOUTHEAST, NORTHWEST, SOUTHWEST, UP, and DOWN, or in short form N, S, E, W, NE, SE, NW, SW, U, and D.

In some locations, IN and OUT will also be useful.

Please press SPACE to continue.

About Interactive Fiction
   What to do with >
   Getting Started
 > Rooms and Travel
   Objects
   Controlling the Game
   How the World is Assembled
   If You Get Stuck

   About Interactive Fiction
   What to do with >
   Getting Started
 > Rooms and Travel
   Objects
   Controlling the Game
   How the World is Assembled
   If You Get Stuck

>[down]
About Interactive Fiction
   What to do with >
   Getting Started
   Rooms and Travel
 > Objects
   Controlling the Game
   How the World is Assembled
   If You Get Stuck

   About Interactive Fiction
   What to do with >
   Getting Started
   Rooms and Travel
 > Objects
   Controlling the Game
   How the World is Assembled
   If You Get Stuck

Throughout the game there will be assorted objects that you can do things with. Most importantly, you may TAKE or GET items, and (when you are tired of them) DROP them again. INVENTORY (abbreviated I) will list the items you are currently holding. 

There are usually assorted things you may do with these objects. OPEN, CLOSE, WEAR, EAT, LOCK, and UNLOCK are especially common.

Occasionally, you will find that the game does not recognize the name of an object even though it has been described as being in the room with you. If this is the case, the object is just there for scenery, and you may assume that you do not need to interact with it.

Please press SPACE to continue.

About Interactive Fiction
   What to do with >
   Getting Started
   Rooms and Travel
 > Objects
   Controlling the Game
   How the World is Assembled
   If You Get Stuck

   About Interactive Fiction
   What to do with >
   Getting Started
   Rooms and Travel
 > Objects
   Controlling the Game
   How the World is Assembled
   If You Get Stuck

>q
Introduction to Saw Escape Room
 > Instructions for Play
   Commands
   About

>[up]
> Introduction to Saw Escape Room
   Instructions for Play
   Commands
   About

 > Introduction to Saw Escape Room
   Instructions for Play
   Commands
   About

This is a simple demonstration Fiction game.

Please press SPACE to continue.

> Introduction to Saw Escape Room
   Instructions for Play
   Commands
   About

 > Introduction to Saw Escape Room
   Instructions for Play
   Commands
   About

>q
Cell
You wake up strapped to a rusted metal bed in a filthy concrete cell. A heavy iron shackle locks your ankle in place, connected by a thick chain to another body nearby. Dark stains cover the floor beneath you, old and dried. The air reeks of metal, mold, and something far worse.

There are no windows. No mercy. Only waiting.

You can see:
- The unconscious man chained beside you
- The heavy iron chain binding you both
- A glowing button on the wall

>check chain
The heavy iron chain binds you to the other prisoner. Each of you wears a tight ankle shackle, far too small to slip free.

The chain passes through an iron bar embedded in the wall. There is no way to pull a body through it. This was engineered with precision.

>check myseld
You can't see any such thing.

>check myself
As good-looking as ever.

>i
You are carrying nothing.

>check man
A man is chained beside you, his body limp and unnaturally still. His head hangs to one side. His breathing is shallow, barely noticeable.

>wake up man
That seems unnecessary.

>shake man
You grab his shoulder and shake him hard. His body reacts, but his eyes never open. Whatever they injected into him has left him completely helpless.

>e
You can't go that way.

>s
You can't go that way.

>n
The wall is solid concrete. There is no exit there. Its not like this chain will let you

>w
You can't go that way.

>check button
A circular metal button embedded in the wall beside you. It pulses faintly, as if aware of your hesitation.

The glowing button is currently switched off.

* * *

>press button
You press the button.

A section of the far wall collapses, revealing a heavy metal door.

A rusty hand saw falls from the ceiling, landing between you and the unconscious man.

Hidden machinery roars to life inside the walls.
The ceiling shudders - then begins to descend.

The ceiling grinds lower, showering you with dust and fragments of concrete.

>take sw
You must name something more substantial.

The ceiling grinds lower, showering you with dust and fragments of concrete.

>take saw
Taken.

The ceiling grinds lower, showering you with dust and fragments of concrete.

>saw chain
You press the blade against the thick iron chain and start sawing desperately.

The metal barely scratches.

The chain is far too thick. There isn't enough time.

The ceiling grinds lower, showering you with dust and fragments of concrete.

* * *

>n
You throw yourself through the doorway as the ceiling crashes down behind you.
You survived - at a terrible cost.

(first opening the cell exit door)

Exit Hall
A narrow concrete corridor stretches into darkness. The air is colder here, heavier. Whatever comes next, you have left the cell behind.

To the north, you can see a heavy metal door marked with biohazard symbols. Behind it, you hear the faint hum of fluorescent lights.

>s
The ceiling has completely collapsed. There is no way back.

>e
You can't go that way.

* * *

>look
Medical Chamber
You step into what appears to be an abandoned operating room. Rusted surgical tools hang from racks on blood-stained walls. A massive examination table dominates the center, covered in leather restraints. The floor is slick with something dark and viscous.

Three glass cylinders stand against the far wall, each containing a severed limb suspended in murky fluid. Above them, a digital counter reads: "SPECIMENS: 3 / 6"

The walls are lined with cabinets, some open, revealing medical supplies in various states of decay.

To the east, you can see a heavy metal door with a complex locking mechanism.

You can see a bloody note on the floor.

>take note
Taken.

>check cabinet
An open medical cabinet containing various supplies.

In the open cabinet are a medical gauze and a medical tape.

>take tape
Taken.

>take gauze
Taken.

>e
(first opening the chamber exit door)
It seems to be locked.

>s
Exit Hall
A narrow concrete corridor stretches into darkness. The air is colder here, heavier. Whatever comes next, you have left the cell behind.

To the north, you can see a heavy metal door marked with biohazard symbols. Behind it, you hear the faint hum of fluorescent lights.

>w
You can't go that way.

>n
Medical Chamber
You step into what appears to be an abandoned operating room. Rusted surgical tools hang from racks on blood-stained walls. A massive examination table dominates the center, covered in leather restraints. The floor is slick with something dark and viscous.

Three glass cylinders stand against the far wall, each containing a severed limb suspended in murky fluid. Above them, a digital counter reads: "SPECIMENS: 3 / 6"

The walls are lined with cabinets, some open, revealing medical supplies in various states of decay.

To the east, you can see a heavy metal door with a complex locking mechanism.

>n
You can't go that way.

>check note
A blood-stained note with shaky handwriting: "The order is written in the colors of water, fire, caution, and life. Blue flows first, Red burns second, Yellow warns third, Green grows last. BLUE - RED - YELLOW - GREEN"

BZZZZT!

A loud buzzer echoes through the chamber. The lights flicker and turn red.

A distorted voice booms from hidden speakers: "YOU HAVE IGNORED THE RULES FOR TOO LONG. THE PUZZLE IS NOW ACTIVE. STEP ON THE COLORED PLATES IN THE CORRECT SEQUENCE TO UNLOCK THE DOOR. EACH MISTAKE WILL COST YOU A PIECE OF YOURSELF. YOU HAVE THREE CHANCES. FAIL THREE TIMES, AND YOU WILL NEVER LEAVE."

The pressure plates on the floor begin to glow ominously.

>step on red plate
You step on the RED plate. It glows brighter and emits a low tone.

>step on blue plate
You step on the BLUE plate. It glows brighter and emits a low tone.

>step on green plate
You step on the GREEN plate. It glows brighter and emits a low tone.

>step on yellow plate
You step on the YELLOW plate. It glows brighter and emits a low tone.

WRONG!

The mechanical device LUNGES forward with terrifying speed. Before you can react, it clamps onto your left hand. You scream as the blade severs your hand at the wrist. The machine retracts, depositing your severed hand into the collection basin.

The digital counter updates: "SPECIMENS: 4 / 6"

The pain is unbearable, but you're still alive.

>step on blue plate
You step on the BLUE plate. It glows brighter and emits a low tone.

>step on blue plate
You step on the BLUE plate. It glows brighter and emits a low tone.

>step on blue plate
You step on the BLUE plate. It glows brighter and emits a low tone.

WRONG AGAIN!

The machine strikes once more. This time it takes your right hand. You fall to your knees, screaming. Blood pours from both wrists.

The counter updates: "SPECIMENS: 5 / 6"

>step on blue plate
You step on the BLUE plate. It glows brighter and emits a low tone.

>step on blue plate
You step on the BLUE plate. It glows brighter and emits a low tone.

WRONG FOR THE LAST TIME!

The machine grabs you by the neck, pulling you into its blades. There is no escape.

The counter updates: "SPECIMENS: 6 / 6"

Everything goes black.

    *** The End ***

Would you like to RESTART, RESTORE a saved game, QUIT or UNDO the last command?

>undo
Medical Chamber
[Previous turn undone.]

>step on blue plate
You step on the BLUE plate. It glows brighter and emits a low tone.

* * *

>step on red plate
You step on the RED plate. It glows brighter and emits a low tone.

>step on yellow
You step on the YELLOW plate. It glows brighter and emits a low tone.

>step on green
You step on the GREEN plate. It glows brighter and emits a low tone.

The plates flash GREEN in sequence. You hear a heavy CLUNK as the door mechanism unlocks.

Behind you, the entrance door SLAMS shut and locks with a mechanical THUNK. There is no going back.

But as you take a step toward freedom, your vision blurs. Blood loss from both severed wrists is too severe. Everything goes dark before your eyes.

You collapse to the floor, unconscious. 

You will never wake up.

    *** The End ***

Would you like to RESTART, RESTORE a saved game, QUIT or UNDO the last command?

>restart
You regain consciousness to the sound of chains and distant machinery.

A distorted voice fills the room.

(Type HELP for list of commands)

Saw Escape Room
An Interactive Fiction by Marko Sokser
Release 1 / Serial number 251215 / Inform 7 v10.1.2 / D

Cell
You wake up strapped to a rusted metal bed in a filthy concrete cell. A heavy iron shackle locks your ankle in place, connected by a thick chain to another body nearby. Dark stains cover the floor beneath you, old and dried. The air reeks of metal, mold, and something far worse.

There are no windows. No mercy. Only waiting.

You can see:
- The unconscious man chained beside you
- The heavy iron chain binding you both
- A glowing button on the wall

>press button
You press the button.

A section of the far wall collapses, revealing a heavy metal door.

A rusty hand saw falls from the ceiling, landing between you and the unconscious man.

Hidden machinery roars to life inside the walls.
The ceiling shudders - then begins to descend.

The ceiling grinds lower, showering you with dust and fragments of concrete.

* * *

>take note
Taken.

>check note
A blood-stained note with shaky handwriting: "The order is written in the colors of water, fire, caution, and life. Blue flows first, Red burns second, Yellow warns third, Green grows last. BLUE - RED - YELLOW - GREEN"

>z
Time passes.

>z
Time passes.

BZZZZT!

A loud buzzer echoes through the chamber. The lights flicker and turn red.

A distorted voice booms from hidden speakers: "YOU HAVE IGNORED THE RULES FOR TOO LONG. THE PUZZLE IS NOW ACTIVE. STEP ON THE COLORED PLATES IN THE CORRECT SEQUENCE TO UNLOCK THE DOOR. EACH MISTAKE WILL COST YOU A PIECE OF YOURSELF. YOU HAVE THREE CHANCES. FAIL THREE TIMES, AND YOU WILL NEVER LEAVE."

The pressure plates on the floor begin to glow ominously.

>step on blue
You step on the BLUE plate. It glows brighter and emits a low tone.

* * *

>step on red
You step on the RED plate. It glows brighter and emits a low tone.

>step on breen
You can't see any such thing.

>step on grren
You can't see any such thing.

>step on green
You step on the GREEN plate. It glows brighter and emits a low tone.

>step on yellow
You step on the YELLOW plate. It glows brighter and emits a low tone.

WRONG!

The mechanical device LUNGES forward with terrifying speed. Before you can react, it clamps onto your left hand. You scream as the blade severs your hand at the wrist. The machine retracts, depositing your severed hand into the collection basin.

The digital counter updates: "SPECIMENS: 4 / 6"

The pain is unbearable, but you're still alive.

>step on blue
You step on the BLUE plate. It glows brighter and emits a low tone.

* * *

>step on yellow
You step on the YELLOW plate. It glows brighter and emits a low tone.

>step on green
You step on the GREEN plate. It glows brighter and emits a low tone.

The plates flash GREEN in sequence. You hear a heavy CLUNK as the door mechanism unlocks.

Behind you, the entrance door SLAMS shut and locks with a mechanical THUNK. There is no going back.

But blood continues to pour from your severed wrist. The pain is overwhelming. You need to stop the bleeding before you can leave, or you won't make it.

>n
You can't go that way.

>e
(first opening the chamber exit door)

Blood spurts from your severed wrist. You're losing blood fast! You need to bandage yourself NOW!

>undo
Medical Chamber
[Previous turn undone.]

>look
Medical Chamber
You step into what appears to be an abandoned operating room. Rusted surgical tools hang from racks on blood-stained walls. A massive examination table dominates the center, covered in leather restraints. The floor is slick with something dark and viscous.

Three glass cylinders stand against the far wall, each containing a severed limb suspended in murky fluid. Above them, a digital counter reads: "SPECIMENS: 3 / 6"

The walls are lined with cabinets, some open, revealing medical supplies in various states of decay.

To the east, you can see a heavy metal door with a complex locking mechanism.

Four colored pressure plates (RED, BLUE, GREEN, and YELLOW) glow ominously on the floor near the chamber exit door.

>check myself
As good-looking as ever.

>look
Medical Chamber
You step into what appears to be an abandoned operating room. Rusted surgical tools hang from racks on blood-stained walls. A massive examination table dominates the center, covered in leather restraints. The floor is slick with something dark and viscous.

Three glass cylinders stand against the far wall, each containing a severed limb suspended in murky fluid. Above them, a digital counter reads: "SPECIMENS: 3 / 6"

The walls are lined with cabinets, some open, revealing medical supplies in various states of decay.

To the east, you can see a heavy metal door with a complex locking mechanism.

Four colored pressure plates (RED, BLUE, GREEN, and YELLOW) glow ominously on the floor near the chamber exit door.

>look
Medical Chamber
You step into what appears to be an abandoned operating room. Rusted surgical tools hang from racks on blood-stained walls. A massive examination table dominates the center, covered in leather restraints. The floor is slick with something dark and viscous.

Three glass cylinders stand against the far wall, each containing a severed limb suspended in murky fluid. Above them, a digital counter reads: "SPECIMENS: 3 / 6"

The walls are lined with cabinets, some open, revealing medical supplies in various states of decay.

To the east, you can see a heavy metal door with a complex locking mechanism.

Four colored pressure plates (RED, BLUE, GREEN, and YELLOW) glow ominously on the floor near the chamber exit door.

* * *

>help
TURING MACHINE SIMULATOR - COMMANDS
======================================

LOAD INCREMENT  - Load binary increment program
LOAD PALINDROME - Load palindrome checker
LOAD EVEN       - Load even ones checker

INPUT <text>    - Set the tape input (e.g., INPUT 1011)
STEP            - Execute one step
EXECUTE         - Run until machine halts
EXAMINE TAPE    - Show current tape state
EXAMINE STATE   - Show machine state
RESET           - Reset the machine
HELP            - Show this help

>load increment
Loaded program: Binary Increment
This program adds 1 to a binary number.
Use INPUT to set a binary number, then RUN or STEP.

>input 1011
Tape set. Current state: [1]011____________
Head at position 0, state: q0

>run
You'll have to say which compass direction to go in.

>load increment
Loaded program: Binary Increment
This program adds 1 to a binary number.
Use INPUT to set a binary number, then RUN or STEP.

>load increment
Loaded program: Binary Increment
This program adds 1 to a binary number.
Use INPUT to set a binary number, then RUN or STEP.

>input 11
Tape set. Current state: [1]1______________
Head at position 0, state: q0

>step
Step 0: State=q0, Tape=[1]1______________
  -> State=q0, Tape=1[1]______________

>step
Step 1: State=q0, Tape=1[1]______________
  -> State=q0, Tape=11[_]_____________

>step
Step 2: State=q0, Tape=11[_]_____________
  -> State=q1, Tape=1[1]______________

>step
Step 3: State=q1, Tape=1[1]______________
  -> State=q1, Tape=[1]0______________

>step
Step 4: State=q1, Tape=[1]0______________
  -> State=q1, Tape=[_]00______________

>step
Step 5: State=q1, Tape=[_]00______________

*** HALTED in state: halt ***
Final tape: [_]00_______________________________1

>reset
Machine reset. Tape cleared, state reset to initial.

>load palindrome
Loaded program: Palindrome Checker
This program checks if the input is a palindrome.
Result will be "accept" or "reject".

>input 101
Tape set. Current state: [1]01_____________
Head at position 0, state: q0

>run
You'll have to say which compass direction to go in.

>reset
Machine reset. Tape cleared, state reset to initial.

* * *

>load palindrome
Loaded program: Palindrome Checker
This program checks if the input is a palindrome.
Result will be "accept" or "reject".

>input 1011
Tape set. Current state: [1]011____________
Head at position 0, state: q0

* * *

>reset
Machine reset. Tape cleared, state reset to initial.

>load increment
Loaded program: Binary Increment
This program adds 1 to a binary number.
Use INPUT to set a binary number, then RUN or STEP.

>input 1010
Tape set. Current state: [1]010____________
Head at position 0, state: q0

>step
Step 0: State=q0, Tape=[1]010____________
  -> State=q0, Tape=1[0]10____________

>step
Step 1: State=q0, Tape=1[0]10____________
  -> State=q0, Tape=10[1]0____________

>examine tape
Tape: 10[1]0____________
Head position: 2

>examine state
Program: increment
State: q0
Step: 2
Halted: false
Tape: 10[1]0____________

>status
Program: increment
State: q0
Step: 2
Halted: false
Tape: 10[1]0____________

>look
Turing Machine Lab
A magnificent Turing Machine awaits your commands.

Program: increment
State: q0
Tape: 10[1]0____________

Type HELP for available commands.

>help
TURING MACHINE SIMULATOR - COMMANDS
======================================

LOAD INCREMENT  - Load binary increment program
LOAD PALINDROME - Load palindrome checker
LOAD EVEN       - Load even ones checker

INPUT <text>    - Set the tape input (e.g., INPUT 1011)
STEP            - Execute one step
EXECUTE         - Run until machine halts
EXAMINE TAPE    - Show current tape state
EXAMINE STATE   - Show machine state
RESET           - Reset the machine
HELP            - Show this help

* * *

>input 1011
Tape set. Current state: [1]011____________
Head at position 0, state: q0

>execute
Running...
Step 0: State=q0, Tape=[1]011____________
Step 1: State=q0, Tape=1[0]11____________
Step 2: State=q0, Tape=10[1]1____________
Step 3: State=q0, Tape=101[1]____________
Step 4: State=q0, Tape=1011[_]___________
Step 5: State=q1, Tape=101[1]____________
Step 6: State=q1, Tape=10[1]0____________
Step 7: State=q1, Tape=1[0]00____________

========================================
Result: HALTED
Final tape: 1[1]00____________
Total steps: 8

>load increment
Loaded program: Binary Increment
This program adds 1 to a binary number.
Use INPUT to set a binary number, then RUN or STEP.

>load palindrome
Loaded program: Palindrome Checker
This program checks if the input is a palindrome.
Result will be "accept" or "reject".

* * *

>input 101
Tape set. Current state: [1]01_____________
Head at position 0, state: q0

>start
Running...
Step 0: State=q0, Tape=[1]01_____________
Step 1: State=find1, Tape=_[0]1_____________
Step 2: State=find1, Tape=_0[1]_____________
Step 3: State=find1, Tape=_01[_]____________
Step 4: State=check1, Tape=_0[1]_____________
Step 5: State=return, Tape=_[0]______________
Step 6: State=return, Tape=[_]0______________
Step 7: State=q0, Tape=_[0]______________
Step 8: State=find0, Tape=__[_]_____________
Step 9: State=check0, Tape=_[_]______________

========================================
Result: ACCEPT
Final tape: _[_]______________
Total steps: 10

* * *

>help
> Introduction to Saw Escape Room
   Instructions for Play
   Commands
   About

>[down]
Introduction to Saw Escape Room
 > Instructions for Play
   Commands
   About

   Introduction to Saw Escape Room
 > Instructions for Play
   Commands
   About

* * *

> Movement
   Interaction
   Special Commands
   Tips

 > Movement
   Interaction
   Special Commands
   Tips

Use N, S, E, W (or NORTH, SOUTH, EAST, WEST) to move between rooms.

Please press SPACE to continue.

* * *

> Movement
   Interaction
   Special Commands
   Tips

 > Movement
   Interaction
   Special Commands
   Tips

>[esc]
Introduction to Saw Escape Room
   Instructions for Play
 > Commands
   About

>[esc]
Cell
You wake up strapped to a rusted metal bed in a filthy concrete cell. A heavy iron shackle locks your ankle in place, connected by a thick chain to another body nearby. Dark stains cover the floor beneath you, old and dried. The air reeks of metal, mold, and something far worse.

There are no windows. No mercy. Only waiting.

You can see:
- The unconscious man chained beside you
- The heavy iron chain binding you both
- A glowing button on the wall

>e
You can't go that way.

* * *

>n
The wall is solid concrete. There is no exit there. Its not like this chain will let you

>check man
A man is chained beside you, his body limp and unnaturally still. His head hangs to one side. His breathing is shallow, barely noticeable.

* * *

>n
You throw yourself through the doorway, dragging him with you, as the ceiling crashes down behind you.
You both survived - at a terrible cost.

(first opening the cell exit door)

Exit Hall
A narrow concrete corridor stretches into darkness. The air is colder here, heavier. Whatever comes next, you have left the cell behind.

To the north, you can see a heavy metal door marked with biohazard symbols. Behind it, you hear the faint hum of fluorescent lights.

Marcus lies unconscious on the cold concrete floor, his bandaged ankle still seeping blood.

>s
The ceiling has completely collapsed. There is no way back.

>n
As you enter the chamber, you notice The man's severed ankle is bleeding heavily. Blood pools beneath him, spreading across the floor. You need to do something quickly, or he won't make it.

Blood continues to pour from The man's wound. His breathing becomes more labored.

* * *

>check cabinet
An open medical cabinet containing various supplies: - Sterile medical gauze - Surgical tape

In the open cabinet are a medical gauze and a medical tape.

The man's breathing is barely detectable. He's losing too much blood!

>take gauze
Taken.

The man's body is going into shock. His pulse is fading. This is his last chance!

>take tape
Taken.

The man's lips are turning blue. His eyes are rolling back. He's dying!

>bandage man
You quickly wrap the gauze around The man's severed ankle, securing it tightly with the medical tape. The bleeding slows and finally stops. His breathing stabilizes slightly. He might actually survive this.

The man's eyes suddenly flutter open. He gasps, looking around in confusion and pain. "What... where am I?" he croaks, his voice hoarse. He looks down at his bandaged ankle and then at you. "You... you saved me. I thought I was going to die in that cell."

>talk to man
Marcus looks at you with pain in his eyes. "We need to get out of here. Look for a way to open that door."

>i
You are carrying:
  a medical tape
  a medical gauze
  a hand saw

>look
Medical Chamber
You step into what appears to be an abandoned operating room. Rusted surgical tools hang from racks on blood-stained walls. A massive examination table dominates the center, covered in leather restraints. The floor is slick with something dark and viscous.

Three glass cylinders stand against the far wall, each containing a severed limb suspended in murky fluid. Above them, a digital counter reads: "SPECIMENS: 3 / 6"

The walls are lined with cabinets, some open, revealing medical supplies in various states of decay.

To the east, you can see a heavy metal door with a complex locking mechanism.

Marcus sits against the wall, clutching his bandaged ankle. His face is pale but his eyes are alert, watching you with a mixture of fear and gratitude.

You can see a bloody note on the floor.

* * *

>step on blue
You step on the BLUE plate. It glows brighter and emits a low tone.

>step on red plate
You step on the RED plate. It glows brighter and emits a low tone.

* * *

>step on yellow
You step on the YELLOW plate. It glows brighter and emits a low tone.

>step on red
You step on the RED plate. It glows brighter and emits a low tone.

WRONG!

The mechanical device LUNGES forward with terrifying speed. Before you can react, it clamps onto your left hand. You scream as the blade severs your hand at the wrist. The machine retracts, depositing your severed hand into the collection basin.

The digital counter updates: "SPECIMENS: 4 / 6"

The pain is unbearable, but you're still alive.

Marcus screams: "NO! Oh God, your hand! Try again, but be careful!"

>undo
Medical Chamber
[Previous turn undone.]

>step on grren
You can't see any such thing.

>step on green
You step on the GREEN plate. It glows brighter and emits a low tone.

The plates flash GREEN in sequence. You hear a heavy CLUNK as the door mechanism unlocks.

Behind you, the entrance door SLAMS shut and locks with a mechanical THUNK. There is no going back.

"You did it!" Marcus shouts. "The door is open!"

>n
You can't go that way.

* * *

>postion chair under vent
That's not a verb I recognise.

>postition chair under vent
That's not a verb I recognise.

>position cabinet under vent
You push the heavy filing cabinet with great effort, slowly moving it across the floor until it's positioned beneath the air vent. It's sturdy, but you'll need to stack something on top to reach the vent.

>postition chair under vent
That's not a verb I recognise.

>position chair under vent
You drag the metal chair across the floor, positioning it directly beneath the air vent. With the cabinet already in place, you carefully climb onto the cabinet and place the chair on top of it. The makeshift tower looks precarious but might work.

>reach vent
You carefully climb onto the filing cabinet, then step up onto the chair balanced on top. The tower wobbles dangerously, but you steady yourself.

You reach toward the vent grate...

SNAP!
 Hidden mechanisms activate instantly. Metal clamps shoot out from the wall, clamping around your wrists!

BOTH your wrists are locked in the mechanisms! You're suspended in the air, completely helpless.

The monitors flicker to life. A distorted figure appears on every screen - The Jigsaw Killer.

"Welcome to your final test," the voice rasps. "You've learned about sacrifice. About pain. But have you learned about TRUST?

Both your hands are locked in place. In exactly 5 minutes, these mechanisms will sever them both. You will fall, and with no hands left, you will bleed out in seconds.

But there is a way to survive..."

The voice pauses for dramatic effect.

"I will ask you ONE question. Answer correctly, and the mechanism releases. Answer incorrectly... and you die.

However, your companion knows the answer. You may ask him for help.

But here's the twist: If you ask him, HE must decide whether to help you or save himself. If he tells you the truth, you both go free. If he lies to save himself, you die and he escapes alone.

The choice is yours. Do you trust him with your life?"

The question appears on all the monitors:

"WHAT IS THE ONE THING THAT CAN BE GIVEN, BUT NEVER TAKEN BACK?"

The monitors display: "ANSWER THE QUESTION OR ASK YOUR COMPANION. TIME IS RUNNING OUT."

* * *

>e
Dark Corridor
You step into a dark, narrow corridor. The walls are cold concrete, barely lit by a single flickering bulb at the far end.

Behind you, the door to the Observation Room stands open. Ahead, another door waits.

Marcus walks beside you, limping but alive.

This nightmare isn't over yet.

You can see an observation exit door, a Marcus and a jaw breaker door here.

* * *

>CODE SACRIFICE TRUST PAIN CHOICE
The terminal screen flashes GREEN.

"CORRECT. YOU HAVE LEARNED THE LESSONS."

You hear heavy locks disengaging. Both doors - north and south - unlock simultaneously.

The terminal displays your final choice:

"FREEDOM lies to the NORTH. Walk away. Survive. Live with your scars.

REVENGE lies to the SOUTH. Confront me. Kill me. Die with me.

The choice is yours, Adam. I will not stop you either way.

What kind of person will you be?"

>N
You stand before the green door marked FREEDOM.

Marcus's face flashes in your mind. His death. His trust. His betrayal. His sacrifice.

You reach for the door handle...

...and pull it open.

Beyond the door is a staircase leading up. You can see daylight filtering down from above.

Fresh air. Freedom. Life.

The weight of the nightmare begins to lift from your shoulders.

(Press Z to continue)
(first opening the freedom door)

You climb the stairs, leaving the nightmare behind.

---

You emerge into an abandoned warehouse district. The sun is setting. You're covered in blood, missing parts of yourself, but you're ALIVE.

You hear sirens in the distance. Help is coming.

Marcus didn't make it. That weight will stay with you forever.

But you survived.

Jigsaw is still out there. Still killing. Still testing.

But you're free.

(Press Z to continue)

>UNDO
Control Room
[Previous turn undone.]

>s
Marcus's face burns in your mind. His screams. His death. His trust that you FAILED.

You chose revenge.

You pull open the red door and step through.

(first opening the revenge door)

He speaks, his voice barely a whisper:

"You came for revenge. I expected nothing less. Marcus's death weighs on you. Good. It should.

But before you kill me, know this: I am already dying. Cancer. Inoperable. I have weeks, maybe days left.

You can end my suffering early. But this facility... it's rigged to explode if my heart stops. A failsafe.

Kill me, and we both die. You'll have your revenge, but you'll never see daylight again.

Or... you can walk away. Let me die slowly, painfully, as I deserve. And you live.

The choice, Adam, is yours."

You can KILL JIGSAW or LEAVE.

* * *

>look
Cell
You wake up strapped to a rusted metal bed in a filthy concrete cell. A heavy iron shackle locks your ankle in place, connected by a thick chain to another body nearby. Dark stains cover the floor beneath you, old and dried. The air reeks of metal, mold, and something far worse.

There are no windows. No mercy. Only waiting.

You can see:
- The unconscious man chained beside you
- The heavy iron chain binding you both
- A glowing button on the wall

>check man
A man is chained beside you, his body limp and unnaturally still. His head hangs to one side. His breathing is shallow, barely noticeable.

>check chain
The heavy iron chain binds you to the other prisoner. Each of you wears a tight ankle shackle, far too small to slip free.

The chain passes through an iron bar embedded in the wall. There is no way to pull a body through it. This was engineered with precision.

* * *

>saw chain
You press the blade against the thick iron chain and start sawing desperately.

The metal barely scratches.

The chain is far too thick. There isn't enough time.

The ceiling grinds lower, showering you with dust and fragments of concrete.

>saw man
That's not something you can cut.

The ceiling grinds lower, showering you with dust and fragments of concrete.

>saw leg
(of the man)
You saw through his ankle. His body jerks violently, but he remains unconscious. The chain finally drops.

The ceiling grinds lower, showering you with dust and fragments of concrete.

>save man
You grab him under the arms and begin dragging his limp body. Every second counts.

The ceiling comes down with terrible finality.
There is no escape.

Everything goes black.

*** Press any key to continue ***

* * *

>check man
A man is chained beside you, his body limp and unnaturally still. His head hangs to one side. His breathing is shallow, barely noticeable.

>chech chaib
That's not a verb I recognise.

>check chain
The heavy iron chain binds you to the other prisoner. Each of you wears a tight ankle shackle, far too small to slip free.

The chain passes through an iron bar embedded in the wall. There is no way to pull a body through it. This was engineered with precision.

>chach button
That's not a verb I recognise.

* * *

>check chain
The heavy iron chain binds you to the other prisoner. Each of you wears a tight ankle shackle, far too small to slip free.

The chain passes through an iron bar embedded in the wall. There is no way to pull a body through it. This was engineered with precision.

>check myself
As good-looking as ever.

>check button
A circular metal button embedded in the wall beside you. It pulses faintly, as if aware of your hesitation.

The glowing button is currently switched off.

* * *

>take saw
Taken.

The ceiling grinds lower, showering you with dust and fragments of concrete.

>saw legt
You can't see any such thing.

>saw leg
(of the man)
You saw through his ankle. His body jerks violently, but he remains unconscious. The chain finally drops.

The ceiling grinds lower, showering you with dust and fragments of concrete.

* * *

>n
As you enter the chamber, you notice The man's severed ankle is bleeding heavily. Blood pools beneath him, spreading across the floor. You need to do something quickly, or he won't make it.

Blood continues to pour from The man's wound. His breathing becomes more labored.

>take tape
Taken.

The man's face is deathly pale. The pool of blood is growing rapidly.

>take gauze
Taken.

The man's breathing is barely detectable. He's losing too much blood!

>bandage man
You quickly wrap the gauze around The man's severed ankle, securing it tightly with the medical tape. The bleeding slows and finally stops. His breathing stabilizes slightly. He might actually survive this.

>wake man
That seems unnecessary.

The man's eyes suddenly flutter open. He gasps, looking around in confusion and pain. "What... where am I?" he croaks, his voice hoarse. He looks down at his bandaged ankle and then at you. "You... you saved me. I thought I was going to die in that cell."

>shake man
He's already awake.

>check man
Marcus sits against the wall, clutching his bandaged ankle. His face is pale but his eyes are alert, watching you with a mixture of fear and gratitude.

>look
Medical Chamber
You step into what appears to be an abandoned operating room. Rusted surgical tools hang from racks on blood-stained walls. A massive examination table dominates the center, covered in leather restraints. The floor is slick with something dark and viscous.

Three glass cylinders stand against the far wall, each containing a severed limb suspended in murky fluid. Above them, a digital counter reads: "SPECIMENS: 3 / 6"

The walls are lined with cabinets, some open, revealing medical supplies in various states of decay.

To the east, you can see a heavy metal door with a complex locking mechanism.

Marcus sits against the wall, clutching his bandaged ankle. His face is pale but his eyes are alert, watching you with a mixture of fear and gratitude.

You can see a bloody note on the floor.

>look
Medical Chamber
You step into what appears to be an abandoned operating room. Rusted surgical tools hang from racks on blood-stained walls. A massive examination table dominates the center, covered in leather restraints. The floor is slick with something dark and viscous.

Three glass cylinders stand against the far wall, each containing a severed limb suspended in murky fluid. Above them, a digital counter reads: "SPECIMENS: 3 / 6"

The walls are lined with cabinets, some open, revealing medical supplies in various states of decay.

To the east, you can see a heavy metal door with a complex locking mechanism.

Marcus sits against the wall, clutching his bandaged ankle. His face is pale but his eyes are alert, watching you with a mixture of fear and gratitude.

You can see a bloody note on the floor.

>look
Medical Chamber
You step into what appears to be an abandoned operating room. Rusted surgical tools hang from racks on blood-stained walls. A massive examination table dominates the center, covered in leather restraints. The floor is slick with something dark and viscous.

Three glass cylinders stand against the far wall, each containing a severed limb suspended in murky fluid. Above them, a digital counter reads: "SPECIMENS: 3 / 6"

The walls are lined with cabinets, some open, revealing medical supplies in various states of decay.

To the east, you can see a heavy metal door with a complex locking mechanism.

Marcus sits against the wall, clutching his bandaged ankle. His face is pale but his eyes are alert, watching you with a mixture of fear and gratitude.

You can see a bloody note on the floor.

BZZZZT!

A loud buzzer echoes through the chamber. The lights flicker and turn red.

A distorted voice booms from hidden speakers: "YOU HAVE IGNORED THE RULES FOR TOO LONG. THE PUZZLE IS NOW ACTIVE. STEP ON THE COLORED PLATES IN THE CORRECT SEQUENCE TO UNLOCK THE DOOR. EACH MISTAKE WILL COST YOU A PIECE OF YOURSELF. YOU HAVE THREE CHANCES. FAIL THREE TIMES, AND YOU WILL NEVER LEAVE."

The pressure plates on the floor begin to glow ominously.

Marcus's voice trembles: "Oh God... we need to figure this out quickly. Look for clues!"

>step on blue palte
I only understood you as far as wanting to step on the blue plate.

>step on blue plate
You step on the BLUE plate. It glows brighter and emits a low tone.

* * *

>step on red plate
You step on the RED plate. It glows brighter and emits a low tone.

>step on yellow plate
You step on the YELLOW plate. It glows brighter and emits a low tone.

>step on green plate
You step on the GREEN plate. It glows brighter and emits a low tone.

The plates flash GREEN in sequence. You hear a heavy CLUNK as the door mechanism unlocks.

Behind you, the entrance door SLAMS shut and locks with a mechanical THUNK. There is no going back.

"You did it!" Marcus shouts. "The door is open!"

>n
You can't go that way.

* * *

>e
(first opening the chamber exit door)

Marcus limps in behind you, leaning against the wall for support. "Another room... another trap," he mutters. "We need to be careful."

>move chair to vent
You can't see any such thing.

>move chair under vent
You drag the metal chair across the floor, positioning it directly beneath the air vent. It's not tall enough on its own - you'll need something else.

>undio
That's not a verb I recognise.

>undo
Observation Room
[Previous turn undone.]

>undo
Observation Room
[Previous turn undone.]

>undo
Medical Chamber
[Previous turn undone.]

>step on red plate
You step on the RED plate. It glows brighter and emits a low tone.

* * *

>check man
A man is chained beside you, his body limp and unnaturally still. His head hangs to one side. His breathing is shallow, barely noticeable.

>press button
You press the button.

A section of the far wall collapses, revealing a heavy metal door.

A rusty hand saw falls from the ceiling, landing between you and the unconscious man.

Hidden machinery roars to life inside the walls.
The ceiling shudders - then begins to descend.

The ceiling grinds lower, showering you with dust and fragments of concrete.

* * *

>save man
You grab him under the arms and begin dragging his limp body. Every second counts.

The ceiling grinds lower, showering you with dust and fragments of concrete.

>n
You throw yourself through the doorway, dragging him with you, as the ceiling crashes down behind you.
You both survived - at a terrible cost.

(first opening the exit door)

Exit Hall
A narrow concrete corridor stretches into darkness. The air is colder here, heavier. Whatever comes next, you have left the cell behind.

To the north, you can see a heavy metal door marked with biohazard symbols. Behind it, you hear the faint hum of fluorescent lights.

Marcus lies unconscious on the cold concrete floor, his bandaged ankle still seeping blood.

>n
As you enter the chamber, you notice The man's severed ankle is bleeding heavily. Blood pools beneath him, spreading across the floor. You need to do something quickly, or he won't make it.

Blood continues to pour from The man's wound. His breathing becomes more labored.

>look
Medical Chamber
You step into what appears to be an abandoned operating room. Rusted surgical tools hang from racks on blood-stained walls. A massive examination table dominates the center, covered in leather restraints. The floor is slick with something dark and viscous.

Three glass cylinders stand against the far wall, each containing a severed limb suspended in murky fluid. Above them, a digital counter reads: "SPECIMENS: 3 / 6"

The walls are lined with cabinets, some open, revealing medical supplies in various states of decay.

To the east, you can see a heavy metal door with a complex locking mechanism.

You can see a man, a chamber exit door and a bloody note here.

The man's face is deathly pale. The pool of blood is growing rapidly.

>check cabinet
An open medical cabinet containing various supplies.

In the open cabinet are a medical gauze and a medical tape.

The man's breathing is barely detectable. He's losing too much blood!

>take tape
Taken.

The man's body is going into shock. His pulse is fading. This is his last chance!

* * *

>bandage man
You quickly wrap the gauze around The man's severed ankle, securing it tightly with the medical tape. The bleeding slows and finally stops. His breathing stabilizes slightly. He might actually survive this.

>check man
The man lies unconscious on the chamber floor. His ankle is bandaged, and the bleeding has stopped. His breathing is shallow but stable.

>shake man
You grab his shoulder and shake him hard. His body reacts, but his eyes never open.

Whatever they injected into him has left him completely helpless.

>wake up man
That seems unnecessary.

>wake man
That seems unnecessary.

BZZZZT!

A loud buzzer echoes through the chamber. The lights flicker and turn red.

A distorted voice booms from hidden speakers: "YOU HAVE IGNORED THE RULES FOR TOO LONG. THE PUZZLE IS NOW ACTIVE. STEP ON THE COLORED PLATES IN THE CORRECT SEQUENCE TO UNLOCK THE DOOR. EACH MISTAKE WILL COST YOU A PIECE OF YOURSELF. YOU HAVE THREE CHANCES. FAIL THREE TIMES, AND YOU WILL NEVER LEAVE."

The pressure plates on the floor begin to glow ominously.

* * *

>check man
A man is chained beside you, his body limp and unnaturally still. His head hangs to one side. His breathing is shallow, barely noticeable.

>wake man
That seems unnecessary.

>shake man
You grab his shoulder and shake him hard. His body reacts, but his eyes never open. Whatever they injected into him has left him completely helpless.

* * *

>check button
A circular metal button embedded in the wall beside you. It pulses faintly, as if aware of your hesitation.

The glowing button is currently switched off.

>e
You can't go that way.

* * *

>s
You can't go that way.

>w
You can't go that way.

>n
The wall is solid concrete. There is no exit there. Its not like this chain will let you

>press button
You press the button.

A section of the far wall collapses, revealing a heavy metal door.

A rusty hand saw falls from the ceiling, landing between you and the unconscious man.

Hidden machinery roars to life inside the walls.
The ceiling shudders - then begins to descend.

The ceiling grinds lower, showering you with dust and fragments of concrete.

>check saw
You see nothing special about the hand saw.

The ceiling grinds lower, showering you with dust and fragments of concrete.

>take saw
Taken.

The ceiling grinds lower, showering you with dust and fragments of concrete.

* * *

>saw chain
You press the blade against the thick iron chain and start sawing desperately.

The metal barely scratches.

The chain is far too thick. There isn't enough time.

The ceiling grinds lower, showering you with dust and fragments of concrete.

>cut myself
You bite down and force the saw through bone and flesh. The pain is indescribable. You collapse - but the chain falls away.

The ceiling grinds lower, showering you with dust and fragments of concrete.

>undo
Cell
[Previous turn undone.]

>saw leg
(of the man)
You saw through his ankle. His body jerks violently, but he remains unconscious. The chain finally drops.

The ceiling grinds lower, showering you with dust and fragments of concrete.

* * *

>undo
Cell
[Previous turn undone.]

>save man
You grab him under the arms and begin dragging his limp body. Every second counts.

The ceiling comes down with terrible finality.
There is no escape.

Everything goes black.

    *** The End ***

Would you like to RESTART, RESTORE a saved game, QUIT or UNDO the last command?

>restart
You regain consciousness to the sound of chains and distant machinery.

A distorted voice fills the room.

(Type HELP for list of commands)

Saw Escape Room
An Interactive Fiction by Marko Sokser
Release 1 / Serial number 251214 / Inform 7 v10.1.2 / D

Cell
You wake up strapped to a rusted metal bed in a filthy concrete cell. A heavy iron shackle locks your ankle in place, connected by a thick chain to another body nearby. Dark stains cover the floor beneath you, old and dried. The air reeks of metal, mold, and something far worse.

There are no windows. No mercy. Only waiting.

You can see:
- The unconscious man chained beside you
- The heavy iron chain binding you both
- A glowing button on the wall

>press button
You press the button.

A section of the far wall collapses, revealing a heavy metal door.

A rusty hand saw falls from the ceiling, landing between you and the unconscious man.

Hidden machinery roars to life inside the walls.
The ceiling shudders - then begins to descend.

The ceiling grinds lower, showering you with dust and fragments of concrete.

* * *

>n
You throw yourself through the doorway as the ceiling crashes down behind you.
You survived - at a terrible cost.

(first opening the cell exit door)

Exit Hall
A narrow concrete corridor stretches into darkness. The air is colder here, heavier. Whatever comes next, you have left the cell behind.

To the north, you can see a heavy metal door marked with biohazard symbols. Behind it, you hear the faint hum of fluorescent lights.

>e
You can't go that way.

* * *

>w
You can't go that way.

>s
The ceiling has completely collapsed. There is no way back.

* * *

>undo
Medical Chamber
[Previous turn undone.]

>undo
Exit Hall
[Previous turn undone.]

>undo
Exit Hall
[Previous turn undone.]

>save man
You can't see any such thing.

>undo
Exit Hall
[Previous turn undone.]

* * *

>save man
You can't see any such thing.

>restart
Are you sure you want to restart?

>zes
Please answer yes or no.

>yes
You regain consciousness to the sound of chains and distant machinery.

A distorted voice fills the room.

(Type HELP for list of commands)

Saw Escape Room
An Interactive Fiction by Marko Sokser
Release 1 / Serial number 251214 / Inform 7 v10.1.2 / D

Cell
You wake up strapped to a rusted metal bed in a filthy concrete cell. A heavy iron shackle locks your ankle in place, connected by a thick chain to another body nearby. Dark stains cover the floor beneath you, old and dried. The air reeks of metal, mold, and something far worse.

There are no windows. No mercy. Only waiting.

You can see:
- The unconscious man chained beside you
- The heavy iron chain binding you both
- A glowing button on the wall

>press button
You press the button.

A section of the far wall collapses, revealing a heavy metal door.

A rusty hand saw falls from the ceiling, landing between you and the unconscious man.

Hidden machinery roars to life inside the walls.
The ceiling shudders - then begins to descend.

The ceiling grinds lower, showering you with dust and fragments of concrete.

* * *

>take tape
Taken.

The man's body is going into shock. His pulse is fading. This is his last chance!

>bandage man
You quickly wrap the gauze around The man's severed ankle, securing it tightly with the medical tape. The bleeding slows and finally stops. His breathing stabilizes slightly. He might actually survive this.

* * *

>check man
The man lies unconscious on the chamber floor. His ankle is bandaged, and the bleeding has stopped. His breathing is shallow but stable.

The man's eyes suddenly flutter open. He gasps, looking around in confusion and pain. "What... where am I?" he croaks, his voice hoarse. He looks down at his bandaged ankle and then at you. "You... you saved me. I thought I was going to die in that cell."

>check man
Marcus sits against the wall, clutching his bandaged ankle. His face is pale but his eyes are alert, watching you with a mixture of fear and gratitude.

>take note
Taken.

* * *

>check note
A blood-stained note with shaky handwriting: "The order is written in the colors of water, fire, caution, and life. Blue flows first, Red burns second, Yellow warns third, Green grows last. BLUE - RED - YELLOW - GREEN"

>e
(first opening the chamber exit door)
It seems to be locked.

BZZZZT!

A loud buzzer echoes through the chamber. The lights flicker and turn red.

A distorted voice booms from hidden speakers: "YOU HAVE IGNORED THE RULES FOR TOO LONG. THE PUZZLE IS NOW ACTIVE. STEP ON THE COLORED PLATES IN THE CORRECT SEQUENCE TO UNLOCK THE DOOR. EACH MISTAKE WILL COST YOU A PIECE OF YOURSELF. YOU HAVE THREE CHANCES. FAIL THREE TIMES, AND YOU WILL NEVER LEAVE."

The pressure plates on the floor begin to glow ominously.

Marcus's voice trembles: "Oh God... we need to figure this out quickly. Look for clues!"

>w
You can't go that way.

>e
(first opening the chamber exit door)
It seems to be locked.

* * *

>s
Exit Hall
A narrow concrete corridor stretches into darkness. The air is colder here, heavier. Whatever comes next, you have left the cell behind.

To the north, you can see a heavy metal door marked with biohazard symbols. Behind it, you hear the faint hum of fluorescent lights.

>n
Medical Chamber
You step into what appears to be an abandoned operating room. Rusted surgical tools hang from racks on blood-stained walls. A massive examination table dominates the center, covered in leather restraints. The floor is slick with something dark and viscous.

Three glass cylinders stand against the far wall, each containing a severed limb suspended in murky fluid. Above them, a digital counter reads: "SPECIMENS: 3 / 6"

The walls are lined with cabinets, some open, revealing medical supplies in various states of decay.

To the east, you can see a heavy metal door with a complex locking mechanism.

Four colored pressure plates (RED, BLUE, GREEN, and YELLOW) glow ominously on the floor near the chamber exit door.

>n
You can't go that way.

>step on blue palte
I only understood you as far as wanting to step on the blue plate.

* * *

>step on yellow plate
You step on the YELLOW plate. It glows brighter and emits a low tone.

>step on green plare
I only understood you as far as wanting to step on the green plate.

>step on green plate
You step on the GREEN plate. It glows brighter and emits a low tone.

The plates flash GREEN in sequence. You hear a heavy CLUNK as the door mechanism unlocks.

Behind you, the entrance door SLAMS shut and locks with a mechanical THUNK. There is no going back.

"You did it!" Marcus shouts. "The door is open!"

>undo
Medical Chamber
[Previous turn undone.]

>step on red plate
You step on the RED plate. It glows brighter and emits a low tone.

WRONG!

The mechanical device LUNGES forward with terrifying speed. Before you can react, it clamps onto your left hand. You scream as the blade severs your hand at the wrist. The machine retracts, depositing your severed hand into the collection basin.

The digital counter updates: "SPECIMENS: 4 / 6"

The pain is unbearable, but you're still alive.

Marcus screams: "NO! Oh God, your hand! Try again, but be careful!"

>step on red plate
You step on the RED plate. It glows brighter and emits a low tone.

>step on red plate
You step on the RED plate. It glows brighter and emits a low tone.

>step on red plate
You step on the RED plate. It glows brighter and emits a low tone.

WRONG AGAIN!

The machine strikes once more. This time it takes your right hand. You fall to your knees, screaming. Blood pours from both wrists.

The counter updates: "SPECIMENS: 5 / 6"

Marcus is crying: "Please, you have to get this right! One more mistake and..."

>step on red plate
You step on the RED plate. It glows brighter and emits a low tone.

>step on red plate
You step on the RED plate. It glows brighter and emits a low tone.

WRONG FOR THE LAST TIME!

The machine grabs you by the neck, pulling you into its blades. There is no escape.

The counter updates: "SPECIMENS: 6 / 6"

Everything goes black.

    *** The End ***

Would you like to RESTART, RESTORE a saved game, QUIT or UNDO the last command?

>undo
Medical Chamber
[Previous turn undone.]

>step on blue plate
You step on the BLUE plate. It glows brighter and emits a low tone.

WRONG FOR THE LAST TIME!

The machine grabs you by the neck, pulling you into its blades. There is no escape.

The counter updates: "SPECIMENS: 6 / 6"

Everything goes black.

    *** The End ***

Would you like to RESTART, RESTORE a saved game, QUIT or UNDO the last command?

* * *

>step on red plate
You step on the RED plate. It glows brighter and emits a low tone.

>step on yeelow plate
You can't see any such thing.

>step on yellow
You step on the YELLOW plate. It glows brighter and emits a low tone.

>step on green plate
You step on the GREEN plate. It glows brighter and emits a low tone.

The plates flash GREEN in sequence. You hear a heavy CLUNK as the door mechanism unlocks.

Behind you, the entrance door SLAMS shut and locks with a mechanical THUNK. There is no going back.

But as you take a step toward freedom, your vision blurs. Blood loss from both severed wrists is too severe. Everything goes dark before your eyes.

You collapse to the floor, unconscious. 

You will never wake up.

    *** The End ***

Would you like to RESTART, RESTORE a saved game, QUIT or UNDO the last command?

>undo
Medical Chamber
[Previous turn undone.]

>Restart
Are you sure you want to restart?

>yes
You regain consciousness to the sound of chains and distant machinery.

A distorted voice fills the room.

(Type HELP for list of commands)

Saw Escape Room
An Interactive Fiction by Marko Sokser
Release 1 / Serial number 251214 / Inform 7 v10.1.2 / D

Cell
You wake up strapped to a rusted metal bed in a filthy concrete cell. A heavy iron shackle locks your ankle in place, connected by a thick chain to another body nearby. Dark stains cover the floor beneath you, old and dried. The air reeks of metal, mold, and something far worse.

There are no windows. No mercy. Only waiting.

You can see:
- The unconscious man chained beside you
- The heavy iron chain binding you both
- A glowing button on the wall

* * *

>look
Cell
You wake up strapped to a rusted metal bed in a filthy concrete cell. A heavy iron shackle locks your ankle in place, connected by a thick chain to another body nearby. Dark stains cover the floor beneath you, old and dried. The air reeks of metal, mold, and something far worse.

There are no windows. No mercy. Only waiting.

You can see:
- The unconscious man chained beside you
- The heavy iron chain binding you both
- A glowing button on the wall

>e
You can't go that way.

* * *

>saw leg
(of the man)
You saw through his ankle. His body jerks violently, but he remains unconscious. The chain finally drops.

The ceiling grinds lower, showering you with dust and fragments of concrete.

>undo
Cell
[Previous turn undone.]

>cut myself
You bite down and force the saw through bone and flesh. The pain is indescribable. You collapse - but the chain falls away.

The ceiling grinds lower, showering you with dust and fragments of concrete.

* * *

>n
You throw yourself through the doorway, dragging him with you, as the ceiling crashes down behind you.
You both survived - at a terrible cost.

(first opening the cell exit door)

Exit Hall
A narrow concrete corridor stretches into darkness. The air is colder here, heavier. Whatever comes next, you have left the cell behind.

To the north, you can see a heavy metal door marked with biohazard symbols. Behind it, you hear the faint hum of fluorescent lights.

Marcus lies unconscious on the cold concrete floor, his bandaged ankle still seeping blood.

>undo
Cell
[Previous turn undone.]

>look
Cell
You wake up strapped to a rusted metal bed in a filthy concrete cell. A heavy iron shackle locks your ankle in place, connected by a thick chain to another body nearby. Dark stains cover the floor beneath you, old and dried. The air reeks of metal, mold, and something far worse.

There are no windows. No mercy. Only waiting.

You can see a cell exit door, a man and a glowing button here.

You can see:
- The unconscious man chained beside you
- A glowing button on the wall
- An exit door to the north

The ceiling comes down with terrible finality.
There is no escape.

Everything goes black.

*** Press any key to continue ***

>undo
Cell
[Previous turn undone.]

* * *

>take tape
Taken.

The man's body is going into shock. His pulse is fading. This is his last chance!

>bandage man
You quickly wrap the gauze around The man's severed ankle, securing it tightly with the medical tape. The bleeding slows and finally stops. His breathing stabilizes slightly. He might actually survive this.

The man's eyes suddenly flutter open. He gasps, looking around in confusion and pain. "What... where am I?" he croaks, his voice hoarse. He looks down at his bandaged ankle and then at you. "You... you saved me. I thought I was going to die in that cell."

>check man
Marcus sits against the wall, clutching his bandaged ankle. His face is pale but his eyes are alert, watching you with a mixture of fear and gratitude.

>talk to man
Marcus looks at you with pain in his eyes. "We need to get out of here. Look for a way to open that door."

* * *

>take note
Taken.

>check note
A blood-stained note with shaky handwriting: "The order is written in the colors of water, fire, caution, and life. Blue flows first, Red burns second, Yellow warns third, Green grows last. BLUE - RED - YELLOW - GREEN"

BZZZZT!

A loud buzzer echoes through the chamber. The lights flicker and turn red.

A distorted voice booms from hidden speakers: "YOU HAVE IGNORED THE RULES FOR TOO LONG. THE PUZZLE IS NOW ACTIVE. STEP ON THE COLORED PLATES IN THE CORRECT SEQUENCE TO UNLOCK THE DOOR. EACH MISTAKE WILL COST YOU A PIECE OF YOURSELF. YOU HAVE THREE CHANCES. FAIL THREE TIMES, AND YOU WILL NEVER LEAVE."

The pressure plates on the floor begin to glow ominously.

Marcus's voice trembles: "Oh God... we need to figure this out quickly. Look for clues!"

>step on blue
You step on the BLUE plate. It glows brighter and emits a low tone.

* * *

>step on green
You step on the GREEN plate. It glows brighter and emits a low tone.

The plates flash GREEN in sequence. You hear a heavy CLUNK as the door mechanism unlocks.

Behind you, the entrance door SLAMS shut and locks with a mechanical THUNK. There is no going back.

"You did it!" Marcus shouts. "The door is open!"

>e
(first opening the chamber exit door)

Marcus limps in behind you, leaning against the wall for support. "Another room... another trap," he mutters. "We need to be careful."

* * *

>move chair under vent
You drag the metal chair across the floor, positioning it directly beneath the air vent. It's not tall enough on its own - you'll need something else.

>move cabinet under vent
You push the heavy filing cabinet with great effort, slowly moving it across the floor until it's positioned beneath the air vent. The chair is already there. You manage to stack the cabinet and chair together, creating a precarious tower.

* * *

>w
Medical Chamber
You step into what appears to be an abandoned operating room. Rusted surgical tools hang from racks on blood-stained walls. A massive examination table dominates the center, covered in leather restraints. The floor is slick with something dark and viscous.

Three glass cylinders stand against the far wall, each containing a severed limb suspended in murky fluid. Above them, a digital counter reads: "SPECIMENS: 3 / 6"

The walls are lined with cabinets, some open, revealing medical supplies in various states of decay.

To the east, you can see a heavy metal door with a complex locking mechanism.

Four colored pressure plates (RED, BLUE, GREEN, and YELLOW) glow ominously on the floor near the chamber exit door.

>e
Observation Room
You step into what appears to be a surveillance room. The walls are lined with cracked monitors, most displaying nothing but static. A few still flicker with grainy footage of empty corridors and cells.

High on the far wall, thin beams of light pierce through an air vent grate. The light draws your attention upward - freedom might lie beyond that vent.

A metal chair sits in the corner, and a filing cabinet stands against the wall.

The room feels claustrophobic, as if it's watching you back.

You can see a chamber exit door, a Marcus, an observation exit door, a metal chair and a filing cabinet here.

>e
Dark Corridor
You step into a dark, narrow corridor. The walls are cold concrete, barely lit by a single flickering bulb at the far end.

Behind you, the door to the Observation Room stands open. Ahead, another door waits.

Marcus walks beside you, limping but alive.

This nightmare isn't over yet.

You can see an observation exit door, a Marcus and a jaw breaker door here.

* * *

>wait
Time passes.

The second question appears:

QUESTION 2: What is the chemical symbol for water?

Marcus answers confidently: "H2O."

You hear a confirmation tone.

"CORRECT."

>wiat
That's not a verb I recognise.

>wait
Time passes.

The third question appears:

QUESTION 3: How many continents are there?

Marcus hesitates. "Uh... six?"

You hear an error tone.

"WRONG. The correct answer is seven."

The device tightens around Marcus's head. He gasps in pain.

"One wrong answer. Two more and the device activates."

>wait
Time passes.

The fourth question appears:

QUESTION 4: What year did World War II end?

Marcus thinks carefully. "1945."

You hear a confirmation tone.

"CORRECT."

>wait
Time passes.

The fifth and final question appears:

QUESTION 5: What is the smallest prime number?

Marcus's face goes pale. He's not sure.

"Um... one?" he guesses.

You hear an error tone.

"WRONG. The correct answer is two."

The device ACTIVATES.

"NO!" Marcus screams.

You watch in horror as the jaw breaker begins to expand.

Marcus's jaw is forced open wider... wider...

CRACK!

His jaw shatters. Blood pours from his mouth.

The device doesn't stop.

CRUNCH!

His skull splits open.

Marcus's body goes limp.

Press any key to continue...

>z
You're too shocked to do anything but wait.

He's dead.

You stand there, frozen in shock.

Marcus... the man who helped you survive. The man you trusted. The man you worked with to escape this nightmare.

Gone.

You feel a wave of emotions crashing over you - shock, anger, frustration, grief.

You drop to your knees, staring at his lifeless body.

"Why?" you whisper. "Why did it have to end like this?"

The silence is deafening.

* * *

>z
You're too shocked to do anything but wait.

Adam: [shouting] "I don't give a crap if you covered yourself in peanut butter and had a 15 hooker gang bang!"

The monitors go dark.

The exit door unlocks with a heavy CLUNK.

Marcus is gone. But you can still move forward.

>n
You can't go that way.

>e
You pause and look back one last time. Marcus's broken body lies in the jaw breaker chamber behind you.

He died because he trusted you. Or did he die because you trusted him?

The questions haunt you as you move forward.

Ahead, you see the final door. Whatever awaits you beyond... this is the end.

* * *

>CODE SARCAFICE TRUST PAIN CHOICE
The terminal screen flashes RED.

"INCORRECT. 2 ATTEMPTS REMAINING."

Think carefully. What were the FOUR core lessons of your journey?

>code sacrafice trust pain choice
The terminal screen flashes RED.

"INCORRECT. 1 ATTEMPTS REMAINING."

This is your LAST chance. Four words. Four lessons.

>CODE SACRIFICE TRUST PAIN CHOICE
The terminal screen flashes GREEN.

"CORRECT. YOU HAVE LEARNED THE LESSONS."

You hear heavy locks disengaging. Both doors - north and south - unlock simultaneously.

The terminal displays your final choice:

"FREEDOM lies to the NORTH. Walk away. Survive. Live with your scars.

REVENGE lies to the SOUTH. Confront me. Kill me. Die with me.

The choice is yours, Adam. I will not stop you either way.

What kind of person will you be?"

>s
Marcus's face burns in your mind. His screams. His death. His trust that you FAILED.

You chose revenge.

You pull open the red door and step through.

(first opening the revenge door)

He speaks, his voice barely a whisper:

"You came for revenge. I expected nothing less. Marcus's death weighs on you. Good. It should.

But before you kill me, know this: I am already dying. Cancer. Inoperable. I have weeks, maybe days left.

You can end my suffering early. But this facility... it's rigged to explode if my heart stops. A failsafe.

Kill me, and we both die. You'll have your revenge, but you'll never see daylight again.

Or... you can walk away. Let me die slowly, painfully, as I deserve. And you live.

The choice, Adam, is yours."

You can KILL JIGSAW or LEAVE.

>leave
But you aren't in anything at the moment.

>LEAVE
But you aren't in anything at the moment.

>Leave jigsaw
You look at the dying man before you.

Marcus is dead. Killing Jigsaw won't bring him back.

"I'm not going to give you what you want," you say. "You want me to become like you. A killer.

I refuse.

You'll die slowly, painfully, alone. That's a better punishment than anything I could do."

Jigsaw's expression doesn't change. He simply nods, almost... respectfully.

"Perhaps you DID learn something after all, Adam. Go. Live. Remember."

You turn and walk back through the control room. You exit through the green door marked FREEDOM.

Beyond the door is a staircase leading up. You can see daylight filtering down from above.

Fresh air. Freedom. Life.

The weight of the nightmare begins to lift from your shoulders.

(Press Z to continue)
You climb the stairs, emerging into daylight.

---

You emerge into daylight. Free. Alive.

Marcus is gone. That pain will never fully heal.

But you chose life over death. Mercy over revenge.

And that makes all the difference.

(Press Z to continue)

>Help
> Introduction to Saw Escape Room
   Instructions for Play
   Commands
   About

>[down]
Introduction to Saw Escape Room
 > Instructions for Play
   Commands
   About

   Introduction to Saw Escape Room
 > Instructions for Play
   Commands
   About

>[enter]
> About Interactive Fiction
   What to do with >
   Getting Started
   Rooms and Travel
   Objects
   Controlling the Game
   How the World is Assembled
   If You Get Stuck

>[down]
About Interactive Fiction
 > What to do with >
   Getting Started
   Rooms and Travel
   Objects
   Controlling the Game
   How the World is Assembled
   If You Get Stuck

   About Interactive Fiction
 > What to do with >
   Getting Started
   Rooms and Travel
   Objects
   Controlling the Game
   How the World is Assembled
   If You Get Stuck

>[down]
About Interactive Fiction
   What to do with >
 > Getting Started
   Rooms and Travel
   Objects
   Controlling the Game
   How the World is Assembled
   If You Get Stuck

   About Interactive Fiction
   What to do with >
 > Getting Started
   Rooms and Travel
   Objects
   Controlling the Game
   How the World is Assembled
   If You Get Stuck

>[down]
About Interactive Fiction
   What to do with >
   Getting Started
 > Rooms and Travel
   Objects
   Controlling the Game
   How the World is Assembled
   If You Get Stuck

   About Interactive Fiction
   What to do with >
   Getting Started
 > Rooms and Travel
   Objects
   Controlling the Game
   How the World is Assembled
   If You Get Stuck

>[down]
About Interactive Fiction
   What to do with >
   Getting Started
   Rooms and Travel
 > Objects
   Controlling the Game
   How the World is Assembled
   If You Get Stuck

   About Interactive Fiction
   What to do with >
   Getting Started
   Rooms and Travel
 > Objects
   Controlling the Game
   How the World is Assembled
   If You Get Stuck

>[down]
About Interactive Fiction
   What to do with >
   Getting Started
   Rooms and Travel
   Objects
 > Controlling the Game
   How the World is Assembled
   If You Get Stuck

   About Interactive Fiction
   What to do with >
   Getting Started
   Rooms and Travel
   Objects
 > Controlling the Game
   How the World is Assembled
   If You Get Stuck

>[down]
About Interactive Fiction
   What to do with >
   Getting Started
   Rooms and Travel
   Objects
   Controlling the Game
 > How the World is Assembled
   If You Get Stuck

   About Interactive Fiction
   What to do with >
   Getting Started
   Rooms and Travel
   Objects
   Controlling the Game
 > How the World is Assembled
   If You Get Stuck

>[up]
About Interactive Fiction
   What to do with >
   Getting Started
   Rooms and Travel
   Objects
 > Controlling the Game
   How the World is Assembled
   If You Get Stuck

   About Interactive Fiction
   What to do with >
   Getting Started
   Rooms and Travel
   Objects
 > Controlling the Game
   How the World is Assembled
   If You Get Stuck

>[up]
About Interactive Fiction
   What to do with >
   Getting Started
   Rooms and Travel
 > Objects
   Controlling the Game
   How the World is Assembled
   If You Get Stuck

   About Interactive Fiction
   What to do with >
   Getting Started
   Rooms and Travel
 > Objects
   Controlling the Game
   How the World is Assembled
   If You Get Stuck

>[up]
About Interactive Fiction
   What to do with >
   Getting Started
 > Rooms and Travel
   Objects
   Controlling the Game
   How the World is Assembled
   If You Get Stuck

   About Interactive Fiction
   What to do with >
   Getting Started
 > Rooms and Travel
   Objects
   Controlling the Game
   How the World is Assembled
   If You Get Stuck

>[up]
About Interactive Fiction
   What to do with >
 > Getting Started
   Rooms and Travel
   Objects
   Controlling the Game
   How the World is Assembled
   If You Get Stuck

   About Interactive Fiction
   What to do with >
 > Getting Started
   Rooms and Travel
   Objects
   Controlling the Game
   How the World is Assembled
   If You Get Stuck

>[up]
About Interactive Fiction
 > What to do with >
   Getting Started
   Rooms and Travel
   Objects
   Controlling the Game
   How the World is Assembled
   If You Get Stuck

   About Interactive Fiction
 > What to do with >
   Getting Started
   Rooms and Travel
   Objects
   Controlling the Game
   How the World is Assembled
   If You Get Stuck

>[up]
> About Interactive Fiction
   What to do with >
   Getting Started
   Rooms and Travel
   Objects
   Controlling the Game
   How the World is Assembled
   If You Get Stuck

 > About Interactive Fiction
   What to do with >
   Getting Started
   Rooms and Travel
   Objects
   Controlling the Game
   How the World is Assembled
   If You Get Stuck

>[up]
> About Interactive Fiction
   What to do with >
   Getting Started
   Rooms and Travel
   Objects
   Controlling the Game
   How the World is Assembled
   If You Get Stuck

 > About Interactive Fiction
   What to do with >
   Getting Started
   Rooms and Travel
   Objects
   Controlling the Game
   How the World is Assembled
   If You Get Stuck

>p
> About Interactive Fiction
   What to do with >
   Getting Started
   Rooms and Travel
   Objects
   Controlling the Game
   How the World is Assembled
   If You Get Stuck

 > About Interactive Fiction
   What to do with >
   Getting Started
   Rooms and Travel
   Objects
   Controlling the Game
   How the World is Assembled
   If You Get Stuck

>p
> About Interactive Fiction
   What to do with >
   Getting Started
   Rooms and Travel
   Objects
   Controlling the Game
   How the World is Assembled
   If You Get Stuck

 > About Interactive Fiction
   What to do with >
   Getting Started
   Rooms and Travel
   Objects
   Controlling the Game
   How the World is Assembled
   If You Get Stuck

>n
About Interactive Fiction
 > What to do with >
   Getting Started
   Rooms and Travel
   Objects
   Controlling the Game
   How the World is Assembled
   If You Get Stuck

   About Interactive Fiction
 > What to do with >
   Getting Started
   Rooms and Travel
   Objects
   Controlling the Game
   How the World is Assembled
   If You Get Stuck

>n
About Interactive Fiction
   What to do with >
 > Getting Started
   Rooms and Travel
   Objects
   Controlling the Game
   How the World is Assembled
   If You Get Stuck

   About Interactive Fiction
   What to do with >
 > Getting Started
   Rooms and Travel
   Objects
   Controlling the Game
   How the World is Assembled
   If You Get Stuck

>n
About Interactive Fiction
   What to do with >
   Getting Started
 > Rooms and Travel
   Objects
   Controlling the Game
   How the World is Assembled
   If You Get Stuck

   About Interactive Fiction
   What to do with >
   Getting Started
 > Rooms and Travel
   Objects
   Controlling the Game
   How the World is Assembled
   If You Get Stuck

>q
Introduction to Saw Escape Room
 > Instructions for Play
   Commands
   About

>q
Jigsaw's Chamber
You enter a small, dimly lit room. Medical equipment lines the walls - ventilators, monitors, IV drips. The air smells of antiseptic and death.

In the center of the room, strapped to a medical bed, is a frail man in his 60s. His skin is pale, almost gray. Tubes run from his arms. His breathing is labored.

This is him. Jigsaw. The monster who orchestrated everything.

But he looks... human. Dying. Weak.

He turns his head slowly to look at you. His eyes are calm, almost serene.

"Hello, Adam," he rasps. "I knew you would come."

You can see a revenge door and Jigsaw here.

>help
> Introduction to Saw Escape Room
   Instructions for Play
   Commands
   About

* * *

>[enter]
LOOK or L - Look around
EXAMINE (object) or X (object) - Examine something
TAKE (object) - Pick up an object
USE (object) - Use an object
INVENTORY or I - Check what you're carrying

Please press SPACE to continue.

Movement
 > Interaction
   Special Commands
   Tips

   Movement
 > Interaction
   Special Commands
   Tips

* * *

>[enter]
SAW LEG - Cut your leg (Cell)
STEP ON (color) PLATE - Medical Chamber puzzle
BANDAGE MYSELF/MARCUS - Stop bleeding
RESPOND (answer) - Answer questions
APPROACH TERMINAL - Control Room
EXAMINE SCREEN - View final puzzle
CODE (text) - Enter terminal code
KILL JIGSAW - Attack Jigsaw
LEAVE - Exit scene

Please press SPACE to continue.

Movement
   Interaction
 > Special Commands
   Tips

   Movement
   Interaction
 > Special Commands
   Tips

* * *

Movement
   Interaction
   Special Commands
 > Tips

   Movement
   Interaction
   Special Commands
 > Tips

>p
Movement
   Interaction
 > Special Commands
   Tips

   Movement
   Interaction
 > Special Commands
   Tips

>p
Movement
 > Interaction
   Special Commands
   Tips

   Movement
 > Interaction
   Special Commands
   Tips

>[esc]
Introduction to Saw Escape Room
   Instructions for Play
 > Commands
   About

* * *

>[down]
About Interactive Fiction
   What to do with >
   Getting Started
   Rooms and Travel
   Objects
 > Controlling the Game
   How the World is Assembled
   If You Get Stuck

   About Interactive Fiction
   What to do with >
   Getting Started
   Rooms and Travel
   Objects
 > Controlling the Game
   How the World is Assembled
   If You Get Stuck

>[up]
About Interactive Fiction
   What to do with >
   Getting Started
   Rooms and Travel
 > Objects
   Controlling the Game
   How the World is Assembled
   If You Get Stuck

   About Interactive Fiction
   What to do with >
   Getting Started
   Rooms and Travel
 > Objects
   Controlling the Game
   How the World is Assembled
   If You Get Stuck

* * *

>[up]
About Interactive Fiction
   What to do with >
   Getting Started
 > Rooms and Travel
   Objects
   Controlling the Game
   How the World is Assembled
   If You Get Stuck

   About Interactive Fiction
   What to do with >
   Getting Started
 > Rooms and Travel
   Objects
   Controlling the Game
   How the World is Assembled
   If You Get Stuck

>[enter]
At any given time, you are in a specific location, or room. When you go into a room, the game will print a description of what you can see there. This description will contain two vital kinds of information: things in the room you can interact with or take, and a list of exits, or ways out. If you want to see the description again, you may just type LOOK. 

When you want to leave a location and go to another one, you may communicate this to the game using compass directions: eg, GO NORTH. For simplicity's sake, you are allowed to omit the word GO, and to abbreviate the compass directions. So you may use NORTH, SOUTH, EAST, WEST, NORTHEAST, SOUTHEAST, NORTHWEST, SOUTHWEST, UP, and DOWN, or in short form N, S, E, W, NE, SE, NW, SW, U, and D.

In some locations, IN and OUT will also be useful.

Please press SPACE to continue.

* * *

About Interactive Fiction
   What to do with >
   Getting Started
 > Rooms and Travel
   Objects
   Controlling the Game
   How the World is Assembled
   If You Get Stuck

   About Interactive Fiction
   What to do with >
   Getting Started
 > Rooms and Travel
   Objects
   Controlling the Game
   How the World is Assembled
   If You Get Stuck

>[esc]
Introduction to Saw Escape Room
 > Instructions for Play
   Commands
   About

>[esc]
Jigsaw's Chamber
You enter a small, dimly lit room. Medical equipment lines the walls - ventilators, monitors, IV drips. The air smells of antiseptic and death.

In the center of the room, strapped to a medical bed, is a frail man in his 60s. His skin is pale, almost gray. Tubes run from his arms. His breathing is labored.

This is him. Jigsaw. The monster who orchestrated everything.

But he looks... human. Dying. Weak.

He turns his head slowly to look at you. His eyes are calm, almost serene.

"Hello, Adam," he rasps. "I knew you would come."

You can see a revenge door and Jigsaw here.

* * *

>look
Cell
You wake up strapped to a rusted metal bed in a filthy concrete cell. A heavy iron shackle locks your ankle in place, connected by a thick chain to another body nearby. Dark stains cover the floor beneath you, old and dried. The air reeks of metal, mold, and something far worse.

There are no windows. No mercy. Only waiting.

You can see:
- The unconscious man chained beside you
- The heavy iron chain binding you both
- A glowing button on the wall

>press button
You press the button.

A section of the far wall collapses, revealing a heavy metal door.

A rusty hand saw falls from the ceiling, landing between you and the unconscious man.

Hidden machinery roars to life inside the walls.
The ceiling shudders - then begins to descend.

The ceiling grinds lower, showering you with dust and fragments of concrete.

* * *

>take saw
Taken.

The ceiling grinds lower, showering you with dust and fragments of concrete.

>saw chain
You press the blade against the thick iron chain and start sawing desperately.

The metal barely scratches.

He doesn't want us to cut through our chains. He wants us to cut through our feet!

The chain is far too thick. There isn't enough time.

The ceiling grinds lower, showering you with dust and fragments of concrete.

* * *

>n
The wall is solid concrete. There is no exit there. Its not like this chain will let you

>check chain
The heavy iron chain binds you to the other prisoner. Each of you wears a tight ankle shackle, far too small to slip free.

The chain passes through an iron bar embedded in the wall. There is no way to pull a body through it. This was engineered with precision.

* * *

>wake man
That seems unnecessary.

>check if man alive
You can't see any such thing.

>shake man
You grab his shoulder and shake him hard. His body reacts, but his eyes never open.

Whatever they injected into him has left him completely helpless.

>check if man is alive
You force yourself to watch his chest. After several agonizing seconds, it rises slightly. He is alive.

>check button
A circular metal button embedded in the wall beside you. It pulses faintly, as if aware of your hesitation.

The glowing button is currently switched off.

* * *

>i
You are carrying:
  a hand saw

The ceiling grinds lower, showering you with dust and fragments of concrete.

>saw man
You saw through his ankle. His scream echoes through the room as the chain finally drops.

The ceiling grinds lower, showering you with dust and fragments of concrete.

>door
That's not a verb I recognise.

>n
You throw yourself through the doorway as the ceiling crashes down behind you.
You survived - at a terrible cost.

(first opening the exit door)

Exit Hall
A narrow concrete corridor stretches into darkness. The air is colder here, heavier. Whatever comes next, you have left the cell behind.

You can see an exit door here.

* * *

>press buton
You can't see any such thing.

>press button
You press the button.

A section of the far wall collapses, revealing a heavy metal door.

A rusty hand saw falls from the ceiling, landing between you and the unconscious man.

Hidden machinery roars to life inside the walls.
The ceiling shudders - then begins to descend.

The ceiling grinds lower, showering you with dust and fragments of concrete.

* * *

>n
As you enter the chamber, you notice The man's severed ankle is bleeding heavily. Blood pools beneath him, spreading across the floor. You need to do something quickly, or he won't make it.

Blood continues to pour from The man's wound. His breathing becomes more labored.

>take gauze
Taken.

The man's face is deathly pale. The pool of blood is growing rapidly.

>take tape
Taken.

The man's breathing is barely detectable. He's losing too much blood!

>bandage man
You quickly wrap the gauze around The man's severed ankle, securing it tightly with the medical tape. The bleeding slows and finally stops. His breathing stabilizes slightly. He might actually survive this.

>shake man
You shake his shoulder firmly, calling out to him. His eyes suddenly flutter open. He gasps, looking around in confusion and pain. "What... where am I?" he croaks, his voice hoarse. He looks down at his bandaged ankle and then at you. "You... you saved me. I thought I was going to die in that cell."

>check man
Marcus sits against the wall, clutching his bandaged ankle. His face is pale but his eyes are alert, watching you with a mixture of fear and gratitude.

* * *

>check note
A blood-stained note with shaky handwriting: "The order is written in the colors of water, fire, caution, and life. Blue flows first, Red burns second, Yellow warns third, Green grows last. BLUE - RED - YELLOW - GREEN"

>check yourself
You can't see any such thing.

>check myself
As good-looking as ever.

BZZZZT!

A loud buzzer echoes through the chamber. The lights flicker and turn red.

A distorted voice booms from hidden speakers: "YOU HAVE IGNORED THE RULES FOR TOO LONG. THE PUZZLE IS NOW ACTIVE. STEP ON THE COLORED PLATES IN THE CORRECT SEQUENCE TO UNLOCK THE DOOR. EACH MISTAKE WILL COST YOU A PIECE OF YOURSELF. YOU HAVE THREE CHANCES. FAIL THREE TIMES, AND YOU WILL NEVER LEAVE."

The pressure plates on the floor begin to glow ominously.

Marcus's voice trembles: "Oh God... we need to figure this out quickly. Look for clues!"

>step on blue plate
You step on the BLUE plate. It glows brighter and emits a low tone.

* * *

>step on green plate
You step on the GREEN plate. It glows brighter and emits a low tone.

The plates flash GREEN in sequence. You hear a heavy CLUNK as the door mechanism unlocks.

Behind you, the entrance door SLAMS shut and locks with a mechanical THUNK. There is no going back.

"You did it!" Marcus shouts. "The door is open!"

>e
(first opening the chamber exit door)

Marcus limps in behind you, leaning against the wall for support. "Another room... another trap," he mutters. "We need to be careful."

>move chair under vent
You drag the metal chair across the floor, positioning it directly beneath the air vent. It's not tall enough on its own - you'll need something else.

* * *

>ask marcuh
You can't see any such thing.

>ask marcus
You look at Marcus desperately.

"Marcus! Do you know the answer?! Please!"

Marcus stares at you, his face conflicted. Sweat beads on his forehead.

The monitors display: "HE KNOWS THE ANSWER. WILL HE SAVE YOU... OR HIMSELF?"

Marcus's voice trembles: "I... I do know it. I remember... from before."

He pauses, looking between you and the chamber exit door.

"But if I tell you... we both go free. If I don't..."

He's considering betraying you.

You can see the internal struggle in his eyes.

What do you say?

(Type "confess your sins" or "lie to marcus")

>confess your sins
You take a deep breath.

"Marcus... I need to tell you something."

Your voice cracks.

"In the cell... when I had to choose... I almost left you behind. I thought about saving only myself. Part of me wanted to."

Tears stream down your face.

"But I didn't. I saved you. And if I could do it again... I'd make the same choice. Because you're worth saving."

Marcus's eyes widen. His expression softens.

"You... you're telling the truth."

He steps closer.

"The answer is TRUST," he says clearly. "The thing that can be given but never taken back is TRUST."

The monitors flash GREEN.

The mechanical clamps release. You fall, catching yourself.

"CORRECT," the voice booms.

Marcus helps you down from the furniture.

"Thank you," he says quietly. "Thank you for being honest. Thank you for saving me."

The observation exit door unlocks with a heavy CLUNK.

You both survived.

* * *

>e
Dark Corridor
You step into a dark, narrow corridor. The walls are cold concrete, barely lit by a single flickering bulb at the far end.

Behind you, the door to the Observation Room stands open. Ahead, another door waits.

Marcus walks beside you, limping but alive.

This nightmare isn't over yet.

You can see an observation exit door, a Marcus and a jaw breaker door here.

>n
You can't go that way.

>s
You can't go that way.

>w
Observation Room
You step into what appears to be a surveillance room. The walls are lined with cracked monitors, most displaying nothing but static. A few still flicker with grainy footage of empty corridors and cells.

High on the far wall, thin beams of light pierce through an air vent grate. The light draws your attention upward - freedom might lie beyond that vent.

A metal chair sits in the corner, and a filing cabinet stands against the wall.

The room feels claustrophobic, as if it's watching you back.

You can see an observation exit door, a chamber exit door, a metal chair and a filing cabinet here.

>e
Dark Corridor
You step into a dark, narrow corridor. The walls are cold concrete, barely lit by a single flickering bulb at the far end.

Behind you, the door to the Observation Room stands open. Ahead, another door waits.

Marcus walks beside you, limping but alive.

This nightmare isn't over yet.

You can see an observation exit door, a Marcus and a jaw breaker door here.

* * *

>e
You can't go that way.

>e
You can't go that way.

>n
You can't go that way.

>play yourself
"No," you say firmly. "I'll play. Not him."

"How noble," Jigsaw's voice mocks. "But I'm afraid that's not an option."

Before you can react, you hear a HISSING sound.

Gas begins pouring into the room from hidden vents in the ceiling.

Marcus screams. "NO! What did you do?!"

The gas fills your lungs. It burns. You can't breathe.

Both of you collapse to the floor, gasping, choking.

Your vision blurs. You try to crawl toward the door, but your body won't respond.

Marcus is next to you, convulsing, his face turning blue.

You can try to STRUGGLE or SHOUT, but time is running out...

* * *

>undo
Jaw Breaker Chamber
[Previous turn undone.]

>play yourself
"No," you say firmly. "I'll play. Not him."

"How noble," Jigsaw's voice mocks. "But I'm afraid that's not an option."

Before you can react, you hear a HISSING sound.

Gas begins pouring into the room from hidden vents in the ceiling.

Marcus screams. "NO! What did you do?!"

The gas fills your lungs. It burns. You can't breathe.

Both of you collapse to the floor, gasping, choking.

Your vision blurs. You try to crawl toward the door, but your body won't respond.

Marcus is next to you, convulsing, his face turning blue.

You can try to STRUGGLE or SHOUT, but time is running out...

>shout
There's no reason to shout.

"You had one simple choice," the voice says coldly. "And you chose wrong."

Everything goes black.

    *** The End ***

Would you like to RESTART, RESTORE a saved game, QUIT or UNDO the last command?

>undo
Jaw Breaker Chamber
[Previous turn undone.]

>undo
Jaw Breaker Chamber
[Previous turn undone.]

* * *

I beg your pardon?

>undo
Jaw Breaker Chamber
[Previous turn undone.]

* * *

>undo
Jaw Breaker Chamber
[Previous turn undone.]

* * *

>z
Time passes.

The fifth and final question appears:

QUESTION 5: What is the smallest prime number?

Marcus's face goes pale. He's not sure.

"Um... one?" he guesses.

You hear an error tone.

"WRONG. The correct answer is two."

The device ACTIVATES.

"NO!" Marcus screams.

You watch in horror as the jaw breaker begins to expand.

Marcus's jaw is forced open wider... wider...

CRACK!

His jaw shatters. Blood pours from his mouth.

The device doesn't stop.

CRUNCH!

His skull splits open.

Marcus's body goes limp.

Press any key to continue...

>undo
Jaw Breaker Chamber
[Previous turn undone.]

>z
Time passes.

The fifth and final question appears:

QUESTION 5: What is the smallest prime number?

Marcus's face goes pale. He's not sure.

"Um... one?" he guesses.

You hear an error tone.

"WRONG. The correct answer is two."

The device ACTIVATES.

"NO!" Marcus screams.

You watch in horror as the jaw breaker begins to expand.

Marcus's jaw is forced open wider... wider...

CRACK!

His jaw shatters. Blood pours from his mouth.

The device doesn't stop.

CRUNCH!

His skull splits open.

Marcus's body goes limp.

Press any key to continue...

* * *

>undo
Jaw Breaker Chamber
[Previous turn undone.]

>z
Time passes.

The fourth question appears:

QUESTION 4: What year did World War II end?

Marcus thinks carefully. "1945."

You hear a confirmation tone.

"CORRECT."

* * *

>z
You're too shocked to do anything but wait.

Press any key to continue...

I beg your pardon?

>z
You're too shocked to do anything but wait.

Adam: [shouting] "I don't give a crap if you covered yourself in peanut butter and had a 15 hooker gang bang!"

The monitors go dark.

The exit door unlocks with a heavy CLUNK.

Marcus is gone. But you can still move forward.

>z
Time passes.

>undo
Jaw Breaker Chamber
[Previous turn undone.]

>z
You're too shocked to do anything but wait.

You can't move. You can't think. All you can do is stare at what's left of your companion.

The monitors flicker. Jigsaw's face appears.

"Unfortunate. But necessary. You see, Adam, this was never about him surviving. This was about YOU learning the cost of trust.

You trusted him to succeed. He failed. And now he's dead because of that trust.

Remember this lesson well."

>undo
Jaw Breaker Chamber
[Previous turn undone.]

>undo
"Undo" capacity exhausted. Sorry!

>z
Time passes.

The fifth and final question appears:

QUESTION 5: What is the smallest prime number?

Marcus's face goes pale. He's not sure.

"Um... one?" he guesses.

You hear an error tone.

"WRONG. The correct answer is two."

The device ACTIVATES.

"NO!" Marcus screams.

You watch in horror as the jaw breaker begins to expand.

Marcus's jaw is forced open wider... wider...

CRACK!

His jaw shatters. Blood pours from his mouth.

The device doesn't stop.

CRUNCH!

His skull splits open.

Marcus's body goes limp.

Press any key to continue...

>undo "Saw Escape Room" by "Marko Sokser"
That's not a verb I recognise.

>undo
Jaw Breaker Chamber
[Previous turn undone.]

>z
You're too shocked to do anything but wait.

He's dead.

You stand there, frozen in shock.

Marcus... the man who helped you survive. The man you trusted. The man you worked with to escape this nightmare.

Gone.

You feel a wave of emotions crashing over you - shock, anger, frustration, grief.

You drop to your knees, staring at his lifeless body.

"Why?" you whisper. "Why did it have to end like this?"

The silence is deafening.

>undo
Jaw Breaker Chamber
[Previous turn undone.]

* * *

>press butoon
You can't see any such thing.

>press button
You press the button.

A section of the far wall collapses, revealing a heavy metal door.

A rusty hand saw falls from the ceiling, landing between you and the unconscious man.

Hidden machinery roars to life inside the walls.
The ceiling shudders - then begins to descend.

The ceiling grinds lower, showering you with dust and fragments of concrete.

* * *

>press button
You press the button.

A section of the far wall collapses, revealing a heavy metal door.

A rusty hand saw falls from the ceiling, landing between you and the unconscious man.

Hidden machinery roars to life inside the walls.
The ceiling shudders - then begins to descend.

The ceiling grinds lower, showering you with dust and fragments of concrete.

* * *

>take saw
Taken.

The ceiling grinds lower, showering you with dust and fragments of concrete.

>cut yourself
You bite down and force the saw through bone and flesh. The pain is indescribable. You collapse - but the chain falls away.

The ceiling grinds lower, showering you with dust and fragments of concrete.

>save man
You are weak from blood loss. You can barely stand. You don't have the strength to drag him.

The ceiling grinds lower, showering you with dust and fragments of concrete.

>n
You throw yourself through the doorway as the ceiling crashes down behind you.
You survived - at a terrible cost.

(first opening the exit door)

Exit Hall
A narrow concrete corridor stretches into darkness. The air is colder here, heavier. Whatever comes next, you have left the cell behind.

To the north, you can see a heavy metal door marked with biohazard symbols. Behind it, you hear the faint hum of fluorescent lights.

>n
As you enter the chamber, you notice your severed ankle is bleeding heavily. Blood pools beneath you, spreading across the floor. You need to stop the bleeding quickly, or you won't make it.

Blood continues to pour from your severed ankle. You feel dizzy and weak.

>look
Medical Chamber
You step into what appears to be an abandoned operating room. Rusted surgical tools hang from racks on blood-stained walls. A massive examination table dominates the center, covered in leather restraints. The floor is slick with something dark and viscous.

Three glass cylinders stand against the far wall, each containing a severed limb suspended in murky fluid. Above them, a digital counter reads: "SPECIMENS: 3 / 6"

The walls are lined with cabinets, some open, revealing medical supplies in various states of decay.

To the east, you can see a heavy metal door with a complex locking mechanism.

You can see a man, a chamber exit door and a bloody note here.

Your vision blurs. The pool of blood beneath you is growing rapidly. You need to stop the bleeding now!

* * *

>take note
Taken.

>take bandage
You can't see any such thing.

>take tape
Taken.

* * *

>take gauze
Taken.

>look
Medical Chamber
You step into what appears to be an abandoned operating room. Rusted surgical tools hang from racks on blood-stained walls. A massive examination table dominates the center, covered in leather restraints. The floor is slick with something dark and viscous.

Three glass cylinders stand against the far wall, each containing a severed limb suspended in murky fluid. Above them, a digital counter reads: "SPECIMENS: 3 / 6"

The walls are lined with cabinets, some open, revealing medical supplies in various states of decay.

To the east, you can see a heavy metal door with a complex locking mechanism.

>i
You are carrying:
  a medical gauze
  a medical tape
  a bloody note
  a hand saw

>check yourself
You can't see any such thing.

>check note
A blood-stained note with shaky handwriting: "The order is written in the colors of water, fire, caution, and life. Blue flows first, Red burns second, Yellow warns third, Green grows last. BLUE - RED - YELLOW - GREEN"

>look
Medical Chamber
You step into what appears to be an abandoned operating room. Rusted surgical tools hang from racks on blood-stained walls. A massive examination table dominates the center, covered in leather restraints. The floor is slick with something dark and viscous.

Three glass cylinders stand against the far wall, each containing a severed limb suspended in murky fluid. Above them, a digital counter reads: "SPECIMENS: 3 / 6"

The walls are lined with cabinets, some open, revealing medical supplies in various states of decay.

To the east, you can see a heavy metal door with a complex locking mechanism.

>look
Medical Chamber
You step into what appears to be an abandoned operating room. Rusted surgical tools hang from racks on blood-stained walls. A massive examination table dominates the center, covered in leather restraints. The floor is slick with something dark and viscous.

Three glass cylinders stand against the far wall, each containing a severed limb suspended in murky fluid. Above them, a digital counter reads: "SPECIMENS: 3 / 6"

The walls are lined with cabinets, some open, revealing medical supplies in various states of decay.

To the east, you can see a heavy metal door with a complex locking mechanism.

BZZZZT!

A loud buzzer echoes through the chamber. The lights flicker and turn red.

A distorted voice booms from hidden speakers: "YOU HAVE IGNORED THE RULES FOR TOO LONG. THE PUZZLE IS NOW ACTIVE. STEP ON THE COLORED PLATES IN THE CORRECT SEQUENCE TO UNLOCK THE DOOR. EACH MISTAKE WILL COST YOU A PIECE OF YOURSELF. YOU HAVE THREE CHANCES. FAIL THREE TIMES, AND YOU WILL NEVER LEAVE."

The pressure plates on the floor begin to glow ominously.

>step on blue plate
You step on the BLUE plate. It glows brighter and emits a low tone.

* * *

>step on yellow plate
You step on the YELLOW plate. It glows brighter and emits a low tone.

>step on yellow plate
You step on the YELLOW plate. It glows brighter and emits a low tone.

WRONG!

The mechanical device LUNGES forward with terrifying speed. Before you can react, it clamps onto your left hand. You scream as the blade severs your hand at the wrist. The machine retracts, depositing your severed hand into the collection basin.

The digital counter updates: "SPECIMENS: 4 / 6"

The pain is unbearable, but you're still alive.

>bandage myself
You're not bleeding.

>step on blue plate
You step on the BLUE plate. It glows brighter and emits a low tone.

* * *

>step on yellow plate
You step on the YELLOW plate. It glows brighter and emits a low tone.

>step on green plate
You step on the GREEN plate. It glows brighter and emits a low tone.

The plates flash GREEN in sequence. You hear a heavy CLUNK as the door mechanism unlocks.

Behind you, the entrance door SLAMS shut and locks with a mechanical THUNK. There is no going back.

But blood continues to pour from your severed wrist. The pain is overwhelming. You need to stop the bleeding before you can leave, or you won't make it.

>bandage myself
You grit your teeth and wrap the gauze around your severed wrist, securing it tightly with the medical tape. The bleeding slows and finally stops. You might actually survive this.

>i
You are carrying:
  a medical gauze
  a medical tape
  a bloody note
  a hand saw

>n
You can't go that way.

>w
You can't go that way.

>e
(first opening the chamber exit door)

>look
Observation Room
You step into what appears to be a surveillance room. The walls are lined with cracked monitors, most displaying nothing but static. A few still flicker with grainy footage of empty corridors and cells.

High on the far wall, thin beams of light pierce through an air vent grate. The light draws your attention upward - freedom might lie beyond that vent.

A metal chair sits in the corner, and a filing cabinet stands against the wall.

The room feels claustrophobic, as if it's watching you back.

You can see a chamber exit door, an observation exit door, a metal chair and a filing cabinet here.

>move chair
Nothing obvious happens.

>position chare
I didn't understand that sentence.

>position cabinet
I didn't understand that sentence.

>position chair under vent
You drag the metal chair across the floor, positioning it directly beneath the air vent. It's not tall enough on its own - you'll need something else.

>position cabinet under vent
You push the heavy filing cabinet with great effort, slowly moving it across the floor until it's positioned beneath the air vent. The chair is already there. You manage to stack the cabinet and chair together, creating a precarious tower.

>reach vent
You carefully climb onto the filing cabinet, then step up onto the chair balanced on top. The tower wobbles dangerously, but you steady yourself.

You reach toward the vent grate...

SNAP!
 Hidden mechanisms activate instantly. Metal clamps shoot out from the wall, clamping around your wrist!

You're trapped, suspended in the air, held by your single hand.

The monitors flicker to life. A distorted figure appears on every screen - The Jigsaw Killer.

"Ah, you've come this far alone... but now your sacrifice has become your doom."

The mechanism begins to activate.

"One hand already gone, and now this one too. There is no escape. No way out. Just... the end."

You can try to STRUGGLE, but it's futile.

Your trapped hand burns with pain. The mechanism is counting down.

>struggle
You pull against the mechanism with all your remaining strength.

But it's futile.

The mechanism activates.

Your last hand is severed.

You fall to the ground.

Your trapped hand burns with pain. The mechanism is counting down.

With no hands, you cannot stop the bleeding.

Your vision fades.

This is the end.

    *** The End ***

Would you like to RESTART, RESTORE a saved game, QUIT or UNDO the last command?

>UNDO
Observation Room
[Previous turn undone.]

>UNDO
Observation Room
[Previous turn undone.]

>UNDO
"Undo" capacity exhausted. Sorry!

* * *

>take tape
Taken.

* * *

>take gauze
Taken.

>take note
Taken.

>n
You can't go that way.

>n
You can't go that way.

>n
You can't go that way.

BZZZZT!

A loud buzzer echoes through the chamber. The lights flicker and turn red.

A distorted voice booms from hidden speakers: "YOU HAVE IGNORED THE RULES FOR TOO LONG. THE PUZZLE IS NOW ACTIVE. STEP ON THE COLORED PLATES IN THE CORRECT SEQUENCE TO UNLOCK THE DOOR. EACH MISTAKE WILL COST YOU A PIECE OF YOURSELF. YOU HAVE THREE CHANCES. FAIL THREE TIMES, AND YOU WILL NEVER LEAVE."

The pressure plates on the floor begin to glow ominously.

>step on blue plate
You step on the BLUE plate. It glows brighter and emits a low tone.

* * *

>step on yellow plate
You step on the YELLOW plate. It glows brighter and emits a low tone.

>step on green plate
You step on the GREEN plate. It glows brighter and emits a low tone.

The plates flash GREEN in sequence. You hear a heavy CLUNK as the door mechanism unlocks.

Behind you, the entrance door SLAMS shut and locks with a mechanical THUNK. There is no going back.

>e
(first opening the chamber exit door)

* * *

>move chair under vent
You drag the metal chair across the floor, positioning it directly beneath the air vent. It's not tall enough on its own - you'll need something else.

* * *

>move cabinet under vent
You push the heavy filing cabinet with great effort, slowly moving it across the floor until it's positioned beneath the air vent. The chair is already there. You manage to stack the cabinet and chair together, creating a precarious tower.

>pull up
You must name something more substantial.

>pull up to vent
You can't see any such thing.

>reach vent
You carefully climb onto the filing cabinet, then step up onto the chair balanced on top. The tower wobbles dangerously, but you steady yourself.

You reach toward the vent grate...

SNAP!
 Hidden mechanisms activate instantly. Metal clamps shoot out from the wall, clamping around your wrist!

Metal clamps shoot out and lock around your entire right arm - from shoulder to wrist! You're held firmly in place.

The monitors flicker to life. A distorted figure appears on every screen - The Jigsaw Killer.

"Welcome to your final test. You've come this far alone. Impressive.

Your arm is locked in place. Answer my question correctly, and you go free.

Answer incorrectly... and this mechanism will pull you into the saw blades behind you. You'll be torn apart."

The voice pauses.

"There is one other way... you can sacrifice your arm. Cut it off and escape. But with only one arm left, survival becomes... difficult.

The choice is yours."

The question appears on all the monitors:

"WHAT IS THE ONE THING THAT CAN BE GIVEN, BUT NEVER TAKEN BACK?"

You can ANSWER the question or use your SAW to cut your arm.

The monitors display: "ANSWER THE QUESTION OR CUT YOUR ARM. YOU HAVE 3 MOVES LEFT."

>saw arm
You pull out the rusty hand saw from your pocket.

With your free hand, you bring it to your trapped arm and begin cutting through the flesh and bone.
 The pain is indescribable. The saw blade tears through muscle, grinds against bone.

But you don't stop.

Blood sprays everywhere.

CRACK!

Your arm falls away. You collapse to the ground, free but bleeding heavily from the shoulder.

You need to bandage your shoulder IMMEDIATELY or you will bleed out!

You have medical supplies available. Use them now!

The question monitor goes dark. The door at the far end of the room unlocks with a heavy CLUNK.

You are free. But at what cost?

Blood spurts from your severed wrist. You're losing blood fast! You need to bandage yourself NOW!

>saw my hand
That's not something you can cut.

Too much blood loss. Your vision goes black. 

You collapse to the floor, unconscious. 

You will never wake up.

    *** The End ***

Would you like to RESTART, RESTORE a saved game, QUIT or UNDO the last command?

>cut my hand
Please give one of the answers above.

Would you like to RESTART, RESTORE a saved game, QUIT or UNDO the last command?

>UNDO
Observation Room
[Previous turn undone.]

>saw off arm
You're not trapped.

Too much blood loss. Your vision goes black. 

You collapse to the floor, unconscious. 

You will never wake up.

    *** The End ***

Would you like to RESTART, RESTORE a saved game, QUIT or UNDO the last command?

>UNDO
Observation Room
[Previous turn undone.]

>look
Observation Room
You step into what appears to be a surveillance room. The walls are lined with cracked monitors, most displaying nothing but static. A few still flicker with grainy footage of empty corridors and cells.

High on the far wall, thin beams of light pierce through an air vent grate. The light draws your attention upward - freedom might lie beyond that vent.

A metal chair sits in the corner, and a filing cabinet stands against the wall.

The room feels claustrophobic, as if it's watching you back.

You can see a chamber exit door, an observation exit door, a metal chair and a filing cabinet here.

>move chair to vent
You can't see any such thing.

I beg your pardon?

>move chair under vent
The chair is already positioned under the vent.

I beg your pardon?

>reach vent
You carefully climb onto the filing cabinet, then step up onto the chair balanced on top. The tower wobbles dangerously, but you steady yourself.

You reach toward the vent grate...

SNAP!
 Hidden mechanisms activate instantly. Metal clamps shoot out from the wall, clamping around your wrist!

Metal clamps shoot out and lock around your entire right arm - from shoulder to wrist! You're held firmly in place.

The monitors flicker to life. A distorted figure appears on every screen - The Jigsaw Killer.

"Welcome to your final test. You've come this far alone. Impressive.

Your arm is locked in place. Answer my question correctly, and you go free.

Answer incorrectly... and this mechanism will pull you into the saw blades behind you. You'll be torn apart."

The voice pauses.

"There is one other way... you can sacrifice your arm. Cut it off and escape. But with only one arm left, survival becomes... difficult.

The choice is yours."

The question appears on all the monitors:

"WHAT IS THE ONE THING THAT CAN BE GIVEN, BUT NEVER TAKEN BACK?"

You can ANSWER the question or use your SAW to cut your arm.

The monitors display: "ANSWER THE QUESTION OR CUT YOUR ARM. YOU HAVE 3 MOVES LEFT."

>saw off arm
You pull out the rusty hand saw from your pocket.

With your free hand, you bring it to your trapped arm and begin cutting through the flesh and bone.
 The pain is indescribable. The saw blade tears through muscle, grinds against bone.

But you don't stop.

Blood sprays everywhere.

CRACK!

Your arm falls away. You collapse to the ground, free but bleeding heavily from the shoulder.

You need to bandage your shoulder IMMEDIATELY or you will bleed out!

You have medical supplies available. Use them now!

The question monitor goes dark. The door at the far end of the room unlocks with a heavy CLUNK.

You are free. But at what cost?

Blood spurts from your severed wrist. You're losing blood fast! You need to bandage yourself NOW!

>bandage myself
You grit your teeth and wrap the gauze around your severed wrist, securing it tightly with the medical tape. The bleeding slows and finally stops. You might actually survive this.

* * *

>take bandage
You can't see any such thing.

* * *

>take note
Taken.

>look
Medical Chamber
You step into what appears to be an abandoned operating room. Rusted surgical tools hang from racks on blood-stained walls. A massive examination table dominates the center, covered in leather restraints. The floor is slick with something dark and viscous.

Three glass cylinders stand against the far wall, each containing a severed limb suspended in murky fluid. Above them, a digital counter reads: "SPECIMENS: 3 / 6"

The walls are lined with cabinets, some open, revealing medical supplies in various states of decay.

To the east, you can see a heavy metal door with a complex locking mechanism.

>look
Medical Chamber
You step into what appears to be an abandoned operating room. Rusted surgical tools hang from racks on blood-stained walls. A massive examination table dominates the center, covered in leather restraints. The floor is slick with something dark and viscous.

Three glass cylinders stand against the far wall, each containing a severed limb suspended in murky fluid. Above them, a digital counter reads: "SPECIMENS: 3 / 6"

The walls are lined with cabinets, some open, revealing medical supplies in various states of decay.

To the east, you can see a heavy metal door with a complex locking mechanism.

>loook
That's not a verb I recognise.

>look
Medical Chamber
You step into what appears to be an abandoned operating room. Rusted surgical tools hang from racks on blood-stained walls. A massive examination table dominates the center, covered in leather restraints. The floor is slick with something dark and viscous.

Three glass cylinders stand against the far wall, each containing a severed limb suspended in murky fluid. Above them, a digital counter reads: "SPECIMENS: 3 / 6"

The walls are lined with cabinets, some open, revealing medical supplies in various states of decay.

To the east, you can see a heavy metal door with a complex locking mechanism.

BZZZZT!

A loud buzzer echoes through the chamber. The lights flicker and turn red.

A distorted voice booms from hidden speakers: "YOU HAVE IGNORED THE RULES FOR TOO LONG. THE PUZZLE IS NOW ACTIVE. STEP ON THE COLORED PLATES IN THE CORRECT SEQUENCE TO UNLOCK THE DOOR. EACH MISTAKE WILL COST YOU A PIECE OF YOURSELF. YOU HAVE THREE CHANCES. FAIL THREE TIMES, AND YOU WILL NEVER LEAVE."

The pressure plates on the floor begin to glow ominously.

* * *

>step on yellow plate
You step on the YELLOW plate. It glows brighter and emits a low tone.

>step on gree plate
You can't see any such thing.

>step on green plate
You step on the GREEN plate. It glows brighter and emits a low tone.

The plates flash GREEN in sequence. You hear a heavy CLUNK as the door mechanism unlocks.

Behind you, the entrance door SLAMS shut and locks with a mechanical THUNK. There is no going back.

* * *

>push chair under vent
You drag the metal chair across the floor, positioning it directly beneath the air vent. It's not tall enough on its own - you'll need something else.

>push cabinet under vent
You push the heavy filing cabinet with great effort, slowly moving it across the floor until it's positioned beneath the air vent. The chair is already there. You manage to stack the cabinet and chair together, creating a precarious tower.

>pull up to vent
You can't see any such thing.

* * *

>trust
That's not a verb I recognise.

>Anwser the question
That's not a verb I recognise.

>cut arm
You pull out the rusty hand saw from your pocket.

With your free hand, you bring it to your trapped arm and begin cutting through the flesh and bone.
 The pain is indescribable. The saw blade tears through muscle, grinds against bone.

But you don't stop.

Blood sprays everywhere.

CRACK!

Your arm falls away. You collapse to the ground, free but bleeding heavily from the shoulder.

You need to bandage your shoulder IMMEDIATELY or you will bleed out!

You have medical supplies available. Use them now!

The question monitor goes dark. The door at the far end of the room unlocks with a heavy CLUNK.

You are free. But at what cost?

Blood spurts from your severed wrist. You're losing blood fast! You need to bandage yourself NOW!

>bandage yourself
You can't see any such thing.

>bandage myself
You grit your teeth and wrap the gauze around your severed wrist, securing it tightly with the medical tape. The bleeding slows and finally stops. You might actually survive this.

>n
You can't go that way.

>r
That's not a verb I recognise.

>e
Dark Corridor
You step into a dark, narrow corridor. The walls are cold concrete, barely lit by a single flickering bulb at the far end.

Behind you, the door to the Observation Room stands open. Ahead, another door waits.

You walk alone. Marcus didn't make it.

This nightmare isn't over yet.

You can see an observation exit door and a jaw breaker door here.

>s
You can't go that way.

* * *

>n
You can't go that way.

>e
Dark Corridor
You step into a dark, narrow corridor. The walls are cold concrete, barely lit by a single flickering bulb at the far end.

Behind you, the door to the Observation Room stands open. Ahead, another door waits.

You walk alone. Marcus didn't make it.

This nightmare isn't over yet.

You can see an observation exit door and a jaw breaker door here.

>e
(first opening the jaw breaker door)

As you step into the room, the door locks behind you automatically.

A distorted voice crackles from hidden speakers in the ceiling.

"Welcome, Adam. You've made it this far alone. Impressive.

This is the Jaw Breaker. A device designed to expand the human jaw beyond its breaking point.

Your test is simple: Put the device on your head. Answer five questions correctly.

You may get TWO questions wrong. But if you fail a third time... the device activates, and your skull will be crushed.

If you answer all five correctly - or survive with only two wrong answers - a compartment will open in the wall containing a key. That key will unlock both the device and the exit door.

Refuse to play, and you will never leave this room.

Your time starts... NOW."

>Undo
Dark Corridor
[Previous turn undone.]

>UNDo
Observation Room
[Previous turn undone.]

>e
Dark Corridor
You step into a dark, narrow corridor. The walls are cold concrete, barely lit by a single flickering bulb at the far end.

Behind you, the door to the Observation Room stands open. Ahead, another door waits.

You walk alone. Marcus didn't make it.

This nightmare isn't over yet.

You can see an observation exit door and a jaw breaker door here.

* * *

>look
Jaw Breaker Chamber
You enter a cold, concrete room lit by a single flickering bulb. The walls are bare except for rust stains and scratch marks - evidence of previous victims.

In the center of the room sits a metal chair, and mounted above it is a horrifying device: a massive mechanical jaw breaker - a metal cage designed to fit over someone's head. Its internal mechanisms gleam with cruel precision.

The door behind you stands open.

A small wall compartment is embedded in the east wall.

You can see a jaw breaker door here.

>EXAMINE CHAIR
A cold metal chair sits directly beneath the jaw breaker device. Restraints dangle from its arms.

>JAW BREAKER
That's not a verb I recognise.

>EXAMINE JAW BREAKER
(the jaw breaker device)
A nightmarish contraption: a metal cage fitted with hydraulic pistons designed to force the jaws apart. Once activated, it will slowly expand until the victim's jaw is shattered and their skull is split open.

It hangs ominously above the chair, waiting.

>EXAMINE DEVICE
A nightmarish contraption: a metal cage fitted with hydraulic pistons designed to force the jaws apart. Once activated, it will slowly expand until the victim's jaw is shattered and their skull is split open.

It hangs ominously above the chair, waiting.

>WEAR DEVICE
You take a deep breath and sit in the cold metal chair.

You reach up and pull the jaw breaker device down over your head.

The moment it settles into place, metal locks SNAP shut around your neck.

You're trapped.

The device is cold against your face. You can feel the internal mechanisms pressing against your jaw.

"Good," the voice says. "Let us begin."

The first question crackles through the speakers...

QUESTION 1: What is the capital of France?

>anwser paris
That's not a verb I recognise.

>ANSWER PARIS
(to yourself)
There is no reply.

>paris
That's not a verb I recognise.

>UNDO
Jaw Breaker Chamber
[Previous turn undone.]

>WEAR DEVICE
You're already wearing it.

>paris
That's not a verb I recognise.

>answer paris
(to yourself)
There is no reply.

>EXAMINE JAW BREAKER
(the jaw breaker device)
A nightmarish contraption: a metal cage fitted with hydraulic pistons designed to force the jaws apart. Once activated, it will slowly expand until the victim's jaw is shattered and their skull is split open.

It's locked around your head. You can feel its cold metal pressing against your face.

>look
Jaw Breaker Chamber
You enter a cold, concrete room lit by a single flickering bulb. The walls are bare except for rust stains and scratch marks - evidence of previous victims.

In the center of the room sits a metal chair, and mounted above it is a horrifying device: a massive mechanical jaw breaker - a metal cage designed to fit over someone's head. Its internal mechanisms gleam with cruel precision.

The door behind you stands open.

A small wall compartment is embedded in the east wall.

You can see a jaw breaker door here.

* * *

>take tape
Taken.

* * *

>lookž
That's not a verb I recognise.

>look
Medical Chamber
You step into what appears to be an abandoned operating room. Rusted surgical tools hang from racks on blood-stained walls. A massive examination table dominates the center, covered in leather restraints. The floor is slick with something dark and viscous.

Three glass cylinders stand against the far wall, each containing a severed limb suspended in murky fluid. Above them, a digital counter reads: "SPECIMENS: 3 / 6"

The walls are lined with cabinets, some open, revealing medical supplies in various states of decay.

To the east, you can see a heavy metal door with a complex locking mechanism.

* * *

>step on blue plate
You step on the BLUE plate. It glows brighter and emits a low tone.

>step on red tape
I only understood you as far as wanting to step on the red plate.

>step on red plate
You step on the RED plate. It glows brighter and emits a low tone.

>step on yellow tape
I only understood you as far as wanting to step on the yellow plate.

>stape on yellow plate
That's not a verb I recognise.

>stape on yellow plate
That's not a verb I recognise.

>step on yellow plate
You step on the YELLOW plate. It glows brighter and emits a low tone.

* * *

>e
(first opening the chamber exit door)

>move chair to vent
You can't see any such thing.

>move cabinet to vent
You can't see any such thing.

>move chair to vent
You can't see any such thing.

>look
Observation Room
You step into what appears to be a surveillance room. The walls are lined with cracked monitors, most displaying nothing but static. A few still flicker with grainy footage of empty corridors and cells.

High on the far wall, thin beams of light pierce through an air vent grate. The light draws your attention upward - freedom might lie beyond that vent.

A metal chair sits in the corner, and a filing cabinet stands against the wall.

The room feels claustrophobic, as if it's watching you back.

You can see a chamber exit door, an observation exit door, a metal chair and a filing cabinet here.

* * *

>move cabinet under vent
You push the heavy filing cabinet with great effort, slowly moving it across the floor until it's positioned beneath the air vent. The chair is already there. You manage to stack the cabinet and chair together, creating a precarious tower.

>pull up to vent
You can't see any such thing.

* * *

>cut arm
You pull out the rusty hand saw from your pocket.

With your free hand, you bring it to your trapped arm and begin cutting through the flesh and bone.
 The pain is indescribable. The saw blade tears through muscle, grinds against bone.

But you don't stop.

Blood sprays everywhere.

CRACK!

Your arm falls away. You collapse to the ground, free but bleeding heavily from the shoulder.

You need to bandage your shoulder IMMEDIATELY or you will bleed out!

You have medical supplies available. Use them now!

The question monitor goes dark. The door at the far end of the room unlocks with a heavy CLUNK.

You are free. But at what cost?

Blood spurts from your severed wrist. You're losing blood fast! You need to bandage yourself NOW!

>bandage myself
You grit your teeth and wrap the gauze around your severed wrist, securing it tightly with the medical tape. The bleeding slows and finally stops. You might actually survive this.

>e
Dark Corridor
You step into a dark, narrow corridor. The walls are cold concrete, barely lit by a single flickering bulb at the far end.

Behind you, the door to the Observation Room stands open. Ahead, another door waits.

You walk alone. Marcus didn't make it.

This nightmare isn't over yet.

You can see an observation exit door and a jaw breaker door here.

>e
(first opening the jaw breaker door)

As you step into the room, the door locks behind you automatically.

A distorted voice crackles from hidden speakers in the ceiling.

"Welcome, Adam. You've made it this far alone. Impressive.

This is the Jaw Breaker. A device designed to expand the human jaw beyond its breaking point.

Your test is simple: Sit on the chair. Put the device on your head. Answer five questions correctly.

You may get TWO questions wrong. But if you fail a third time... the device activates, and your skull will be crushed.

If you answer all five correctly - or survive with only two wrong answers - a compartment will open in the wall containing a key. That key will unlock both the device and the exit door.

Refuse to play, and you will never leave this room.

Your time starts... NOW."

>take device
That's hardly portable.

>put on device
You take a deep breath and sit in the cold metal chair.

You reach up and pull the jaw breaker device down over your head.

The moment it settles into place, metal locks SNAP shut around your neck.

You're trapped.

The device is cold against your face. You can feel the internal mechanisms pressing against your jaw.

"Good," the voice says. "Let us begin."

The first question crackles through the speakers...

QUESTION 1: What is the capital of France?

>paris
That's not a verb I recognise.

>anwswer paris
That's not a verb I recognise.

>ANSWER PARIS
(to yourself)
There is no reply.

* * *

>paris
That's not a verb I recognise.

>Answer paris
(to yourself)
There is no reply.

>answer paris
(to yourself)
There is no reply.

>paris
That's not a verb I recognise.

>responde paris
That's not a verb I recognise.

>RESPOND PARIS
You hear a confirmation tone.

"CORRECT."

You have 1 correct answer. You need 3 correct answers to pass.

The next question appears on the screen...

QUESTION 2: What is the largest ocean on Earth?

>UNDO
Jaw Breaker Chamber
[Previous turn undone.]

>respond paris
You hear a confirmation tone.

"CORRECT."

You have 1 correct answer. You need 3 correct answers to pass.

The next question appears on the screen...

QUESTION 2: What is the largest ocean on Earth?

>respond pacific
You hear a confirmation tone.

"CORRECT."

You have 2 correct answers. You need 3 correct answers to pass.

The next question appears on the screen...

QUESTION 3: How many sides does a square have?

>respond 4
You hear a confirmation tone.

"CORRECT."

"You have answered 3 questions correctly. You have passed the test."

A compartment in the wall slides open with a mechanical hiss, revealing a brass key.

You can now TAKE the KEY to unlock the device and escape.

>respond gold
The puzzle isn't active.

>undo
Jaw Breaker Chamber
[Previous turn undone.]

>gold
That's not a verb I recognise.

>respond gold
The puzzle isn't active.

>respond hamlet
The puzzle isn't active.

I beg your pardon?

>UNDO
Jaw Breaker Chamber
[Previous turn undone.]

>UNDO
Jaw Breaker Chamber
[Previous turn undone.]

>respond paris
You hear an error tone.

"WRONG."

The device tightens slightly around your jaw. You feel pressure building.

"You have 2 wrong answers remaining before the device activates."

You have 2 correct answers. You need 3 correct answers to pass.

The next question appears...

QUESTION 4: What element does "Au" represent on the periodic table?

>undo
Jaw Breaker Chamber
[Previous turn undone.]

>respond pacific
You hear a confirmation tone.

"CORRECT."

You have 2 correct answers. You need 3 correct answers to pass.

The next question appears on the screen...

QUESTION 3: How many sides does a square have?

>respond 3
You hear an error tone.

"WRONG."

The device tightens slightly around your jaw. You feel pressure building.

"You have 2 wrong answers remaining before the device activates."

You have 2 correct answers. You need 3 correct answers to pass.

The next question appears...

QUESTION 4: What element does "Au" represent on the periodic table?

>respond gold
You hear a confirmation tone.

"CORRECT."

"You have answered 3 questions correctly. You have passed the test."

A compartment in the wall slides open with a mechanical hiss, revealing a brass key.

You can now TAKE the KEY to unlock the device and escape.

>undo
Jaw Breaker Chamber
[Previous turn undone.]

>respond london
You hear an error tone.

"WRONG."

The device tightens slightly around your jaw. You feel pressure building.

"You have 2 wrong answers remaining before the device activates."

You have 0 correct answers. You need 3 correct answers to pass.

The next question appears...

QUESTION 2: What is the largest ocean on Earth?

>respond silent
You hear an error tone.

"WRONG."

The device tightens slightly around your jaw. You feel pressure building.

"You have 1 wrong answer remaining before the device activates."

You have 0 correct answers. You need 3 correct answers to pass.

The next question appears...

QUESTION 3: How many sides does a square have?

>respond 6
You hear an error tone.

"WRONG."

You scream, but the device doesn't stop.

CRACK!

Your jaw shatters. Blood fills your mouth.

The device continues expanding.

CRUNCH!

Your skull splits open.

Darkness.

*** Press any key to continue ***

>undo
Jaw Breaker Chamber
[Previous turn undone.]

>respond prais
You hear an error tone.

"WRONG."

The device tightens slightly around your jaw. You feel pressure building.

"You have 2 wrong answers remaining before the device activates."

You have 0 correct answers. You need 3 correct answers to pass.

The next question appears...

QUESTION 2: What is the largest ocean on Earth?

>respond pacific
You hear a confirmation tone.

"CORRECT."

You have 1 correct answer. You need 3 correct answers to pass.

The next question appears on the screen...

QUESTION 3: How many sides does a square have?

>respond 4
You hear a confirmation tone.

"CORRECT."

You have 2 correct answers. You need 3 correct answers to pass.

The next question appears on the screen...

QUESTION 4: What element does "Au" represent on the periodic table?

>respond gold
You hear a confirmation tone.

"CORRECT."

"You have answered 3 questions correctly. You have passed the test."

A compartment in the wall slides open with a mechanical hiss, revealing a brass key.

You can now TAKE the KEY to unlock the device and escape.

>respond hamlet
The puzzle isn't active.

>undo
Jaw Breaker Chamber
[Previous turn undone.]

>respond paris
You hear an error tone.

"WRONG."

The device tightens slightly around your jaw. You feel pressure building.

"You have 1 wrong answer remaining before the device activates."

You have 0 correct answers. You need 3 correct answers to pass.

The next question appears...

QUESTION 3: How many sides does a square have?

>respond 4
You hear a confirmation tone.

"CORRECT."

You have 1 correct answer. You need 3 correct answers to pass.

The next question appears on the screen...

QUESTION 4: What element does "Au" represent on the periodic table?

>respond gold
You hear a confirmation tone.

"CORRECT."

You have 2 correct answers. You need 3 correct answers to pass.

The next question appears on the screen...

QUESTION 5: Who wrote "Romeo and Juliet"?

>respond hamlet
You hear an error tone.

"WRONG."

You scream, but the device doesn't stop.

CRACK!

Your jaw shatters. Blood fills your mouth.

The device continues expanding.

CRUNCH!

Your skull splits open.

Darkness.

*** Press any key to continue ***

>undo
Jaw Breaker Chamber
[Previous turn undone.]

>respond shakesparee
You hear an error tone.

"WRONG."

You scream, but the device doesn't stop.

CRACK!

Your jaw shatters. Blood fills your mouth.

The device continues expanding.

CRUNCH!

Your skull splits open.

Darkness.

*** Press any key to continue ***

>undo
Jaw Breaker Chamber
[Previous turn undone.]

>respond shakespeare
You hear a confirmation tone.

"CORRECT."

"You have answered 3 questions correctly. You have passed the test."

A compartment in the wall slides open with a mechanical hiss, revealing a brass key.

You can now TAKE the KEY to unlock the device and escape.

>take key
Taken.

>unlock device
What do you want to unlock the jaw breaker device with?

>unlock device with key
With trembling hands, you insert the key into the lock mechanism on the side of the device.

CLICK!

The locks release. The jaw breaker lifts away from your head.

You're free.

You stand up from the chair, breathing heavily. You survived.

The exit door unlocks with a heavy CLUNK.

>use key
I didn't understand that sentence.

>unlock the device with key
You're not wearing the device.

>i
You are carrying:
  a jaw key
  a bloody note
  a medical gauze
  a medical tape
  a hand saw

>use jaw key
I didn't understand that sentence.

>unlock device with jaw key
You're not wearing the device.

>n
You can't go that way.

>e
You've made it this far. Alone, wounded, but alive.

The final door looms ahead. Whatever waits beyond... you're ready.

>e
(first opening the final entrance door)

>u
You step into the control room. Monitors line the walls, surveillance equipment hums with dormant power.

In the center of the room stands a large computer terminal.

You can APPROACH the terminal or EXAMINE it.

>examine terminal
Which do you mean, the computer terminal or the terminal screen?

>examine computer terminal
You approach the terminal. As you get closer, the screen flickers to life.

All the monitors around the room suddenly activate. Jigsaw's face appears on every screen.

"Welcome to the end, Adam. You have survived every trap, every test, every choice I set before you.

You came here alone, carrying only your own sins and sacrifices.

But survival is not the same as understanding.

To leave this place, you must prove you have learned the lessons. Solve the final puzzle at the terminal.

And then... you will face one last choice.

Will you walk away... or will you seek revenge?

Choose wisely, Adam. Your life depends on it."

The screens go dark.

You can now EXAMINE the SCREEN to see the final test.

>examine screen
You lean closer to the terminal screen. Text begins to scroll across it:

FINAL TEST INITIALIZED.

I have tested your body. I have tested your mind. I have tested your morality.

Now I test your understanding.

Throughout your journey, you have encountered four key lessons: - What you gave up to survive - Who you relied on or betrayed - What you endured - The decisions that defined you

Enter the four-word code that represents these lessons. Format: WORD1 WORD2 WORD3 WORD4

Type: CODE (your answer)

Suddenly, an alarm begins to blare throughout the facility! Red lights flash.

You can now TYPE your answer into the terminal.

>respond pain
There's no question to answer.

>respond pain
There's no question to answer.

>code pain
The terminal screen flashes RED.

"INCORRECT. 2 ATTEMPTS REMAINING."

Think carefully. What were the FOUR core lessons of your journey?

>code pain
The terminal screen flashes RED.

"INCORRECT. 1 ATTEMPTS REMAINING."

This is your LAST chance. Four words. Four lessons.

>code pain
The terminal screen flashes RED.

"INCORRECT. 0 ATTEMPTS REMAINING."

>code pain
The terminal has locked you out after too many failed attempts.

The terminal screen flashes RED.

A computerized voice echoes: "INCORRECT. SELF-DESTRUCT SEQUENCE INITIATED."

Alarms blare. Red lights flash throughout the facility.

"You failed to learn," Jigsaw's voice echoes. "And now... it ends."

10... 9... 8...

The walls shake violently.

7... 6... 5...

You run for the door, but it's too late.

4... 3... 2... 1...

BOOM.

(Press Z to continue)
The entire facility explodes in a massive fireball.

You are consumed by the flames.

(Press Z to continue)

>undo
Control Room
[Previous turn undone.]

>code sacrafice trust pain choice
The terminal has locked you out after too many failed attempts.

The terminal screen flashes RED.

A computerized voice echoes: "INCORRECT. SELF-DESTRUCT SEQUENCE INITIATED."

Alarms blare. Red lights flash throughout the facility.

"You failed to learn," Jigsaw's voice echoes. "And now... it ends."

10... 9... 8...

The walls shake violently.

7... 6... 5...

You run for the door, but it's too late.

4... 3... 2... 1...

BOOM.

(Press Z to continue)
The entire facility explodes in a massive fireball.

You are consumed by the flames.

(Press Z to continue)

>undo
Control Room
[Previous turn undone.]

>undo
Control Room
[Previous turn undone.]

>code sacrafice trust pain choice
The terminal screen flashes RED.

"INCORRECT. 1 ATTEMPTS REMAINING."

This is your LAST chance. Four words. Four lessons.

>CODE SACRAFICE TRUST PAIN CHOICE
The terminal screen flashes RED.

"INCORRECT. 0 ATTEMPTS REMAINING."

>UNDO
Control Room
[Previous turn undone.]

>code sacrifice trust pain choice
The terminal screen flashes GREEN.

"CORRECT. YOU HAVE LEARNED THE LESSONS."

You hear heavy locks disengaging. Both doors - north and south - unlock simultaneously.

The terminal displays your final choice:

"FREEDOM lies to the NORTH. Walk away. Survive. Live with your scars.

REVENGE lies to the SOUTH. Confront me. Kill me. Die with me.

The choice is yours, Adam. I will not stop you either way.

What kind of person will you be?"

>n
You stand before the green door marked FREEDOM.

You think of everything you endured. Every cut, every choice, every moment of pain.

You reach for the door handle...

...and pull it open.

Beyond the door is a staircase leading up. You can see daylight filtering down from above.

Fresh air. Freedom. Life.

The weight of the nightmare begins to lift from your shoulders.

(Press Z to continue)
(first opening the freedom door)

You climb the stairs, leaving the nightmare behind.

---

You emerge into an abandoned warehouse district. The sun is setting. You're covered in blood, missing parts of yourself, but you're ALIVE.

You hear sirens in the distance. Help is coming.

You survived alone. Against all odds.

But you survived.

Jigsaw is still out there. Still killing. Still testing.

But you're free.

(Press Z to continue)

>undo
Control Room
[Previous turn undone.]

>n
You stand before the green door marked FREEDOM.

You think of everything you endured. Every cut, every choice, every moment of pain.

You reach for the door handle...

...and pull it open.

Beyond the door is a staircase leading up. You can see daylight filtering down from above.

Fresh air. Freedom. Life.

The weight of the nightmare begins to lift from your shoulders.

(Press Z to continue)
(first opening the freedom door)

You climb the stairs, leaving the nightmare behind.

---

You emerge into an abandoned warehouse district. The sun is setting. You're covered in blood, missing parts of yourself, but you're ALIVE.

You hear sirens in the distance. Help is coming.

You survived alone. Against all odds.

But you survived.

Jigsaw is still out there. Still killing. Still testing.

But you're free.

(Press Z to continue)

* * *

>undo
Control Room
[Previous turn undone.]

>w
Final Corridor
You step through the doorway into a dimly lit corridor. Emergency lights flicker overhead, casting long shadows on the concrete walls.

At the end of the corridor, you can see a heavy steel door marked with a red biohazard symbol. This feels like the end of something.

You can see a final entrance door and a final corridor door here.

>n
You can't go that way.

>e
Control Room
You enter what appears to be the heart of this nightmare - a surveillance control room filled with monitors, cables, and machinery.

Dozens of screens line the walls, displaying footage from all the rooms you've passed through: the cell, the medical chamber, the observation room, the jaw breaker chamber. You can see your own journey played back in silent horror.

In the center of the room sits a large computer terminal with a keyboard and screen. The screen displays:

"FINAL TEST INITIALIZED. PROVE YOU HAVE LEARNED THE LESSON."

To the north, you see a green door marked "EXIT - FREEDOM". To the south, you see a red door marked "JIGSAW - INNER SANCTUM".

Both doors are locked. The terminal seems to control them.

You can see a final entrance door, a revenge door and a freedom door here.

>s
You chose revenge over survival.

You pull open the red door and step through.

(first opening the revenge door)

He speaks, his voice barely a whisper:

"You came for revenge. I expected nothing less. You seek to end the one who hurt you. I understand.

But before you kill me, know this: I am already dying. Cancer. Inoperable. I have weeks, maybe days left.

You can end my suffering early. But this facility... it's rigged to explode if my heart stops. A failsafe.

Kill me, and we both die. You'll have your revenge, but you'll never see daylight again.

Or... you can walk away. Let me die slowly, painfully, as I deserve. And you live.

The choice, Adam, is yours."

You can KILL JIGSAW or LEAVE.

>leave
But you aren't in anything at the moment.

>leave jigsaw
You look at the dying man before you.

Revenge won't heal your wounds.

"I'm not going to give you what you want," you say. "You want me to become like you. A killer.

I refuse.

You'll die slowly, painfully, alone. That's a better punishment than anything I could do."

Jigsaw's expression doesn't change. He simply nods, almost... respectfully.

"Perhaps you DID learn something after all, Adam. Go. Live. Remember."

You turn and walk back through the control room. You exit through the green door marked FREEDOM.

Beyond the door is a staircase leading up. You can see daylight filtering down from above.

Fresh air. Freedom. Life.

The weight of the nightmare begins to lift from your shoulders.

(Press Z to continue)
You climb the stairs, emerging into daylight.

---

You emerge into daylight. Free. Alive.

You survived, scarred but unbroken.

But you chose life over death. Mercy over revenge.

And that makes all the difference.

(Press Z to continue)

>undo
Jigsaw's Chamber
[Previous turn undone.]

>kill jigsaw
"This ends NOW," you growl.

Your hands close around his frail throat with brutal force.

He doesn't resist. He simply watches you with those calm, knowing eyes - even now, in control.

That infuriates you MORE.

You SQUEEZE. Hard. Your fingers dig deep into his flesh, crushing his windpipe.

His eyes bulge. His face turns purple. Blood vessels burst in his eyes.

His body convulses, tubes ripping from his arms. Medical monitors SHRIEK in alarm.

You don't let go. You squeeze HARDER.

His breathing becomes desperate, wet, gurgling... then stops.

His body goes limp.

His heart stops beating.

For a moment, there is only silence.

The monster is dead. By YOUR hands.

It's finally OVER.

(Press Z to continue)

>z
Time passes.

Then...

A compartment in the wall suddenly slides open with a mechanical CLICK.

A small figure emerges on a mechanical track - a miniature PUPPET on a tricycle, dressed like Jigsaw.

Its eyes glow red. Its mouth opens...

"HAHAHAHAHA! I WANT TO PLAY A GAME!"

"HAHAHAHAHA! I WANT TO PLAY A GAME!"

The mechanical laugh echoes through the room.

(Press Z to continue)

>z
Time passes.

"Congratulations, Adam. You killed me. But did you really think... it would be that SIMPLE?

This facility is rigged with EXPLOSIVES. The moment my heart stopped... you triggered the failsafe.

I told you what would happen. You CHOSE this.

Welcome to your GRAVE!"

BEEEEEEEEP.

An alarm blares throughout the facility. Red lights flash.

A computerized voice echoes: "HEART RATE ZERO DETECTED. SELF-DESTRUCT SEQUENCE ACTIVATED. DETONATION IN 10 SECONDS."

10... 9... 8...

You run for the door, but it SLAMS shut and locks.

7... 6... 5...

There is no escape.

4... 3... 2...

At least you took him with you.

1...

BOOM.

(Press Z to continue)

>undo
Jigsaw's Chamber
[Previous turn undone.]

>undo
Jigsaw's Chamber
[Previous turn undone.]

* * *

>unlock device with jaw key
You're not wearing the device.

>unlock device
What do you want to unlock the jaw breaker device with?

>unlock the device with key
You're not wearing the device.

* * *

>check note
A blood-stained note with shaky handwriting: "The order is written in the colors of water, fire, caution, and life. Blue flows first, Red burns second, Yellow warns third, Green grows last. BLUE - RED - YELLOW - GREEN"

>check myself
As good-looking as ever.

>look
Medical Chamber
You step into what appears to be an abandoned operating room. Rusted surgical tools hang from racks on blood-stained walls. A massive examination table dominates the center, covered in leather restraints. The floor is slick with something dark and viscous.

Three glass cylinders stand against the far wall, each containing a severed limb suspended in murky fluid. Above them, a digital counter reads: "SPECIMENS: 3 / 6"

The walls are lined with cabinets, some open, revealing medical supplies in various states of decay.

To the east, you can see a heavy metal door with a complex locking mechanism.

>i
You are carrying:
  a bloody note
  a medical gauze
  a medical tape
  a hand saw

>n
You can't go that way.

BZZZZT!

A loud buzzer echoes through the chamber. The lights flicker and turn red.

A distorted voice booms from hidden speakers: "YOU HAVE IGNORED THE RULES FOR TOO LONG. THE PUZZLE IS NOW ACTIVE. STEP ON THE COLORED PLATES IN THE CORRECT SEQUENCE TO UNLOCK THE DOOR. EACH MISTAKE WILL COST YOU A PIECE OF YOURSELF. YOU HAVE THREE CHANCES. FAIL THREE TIMES, AND YOU WILL NEVER LEAVE."

The pressure plates on the floor begin to glow ominously.

* * *

>step on green plate
You step on the GREEN plate. It glows brighter and emits a low tone.

The plates flash GREEN in sequence. You hear a heavy CLUNK as the door mechanism unlocks.

Behind you, the entrance door SLAMS shut and locks with a mechanical THUNK. There is no going back.

>n
You can't go that way.

>e
(first opening the chamber exit door)

* * *

>move cabinet under vent
You push the heavy filing cabinet with great effort, slowly moving it across the floor until it's positioned beneath the air vent. The chair is already there. You manage to stack the cabinet and chair together, creating a precarious tower.

>push to vent
You can't see any such thing.

>push up to vent
You can't see any such thing.

>pull up
You must name something more substantial.

>reach vent
You carefully climb onto the filing cabinet, then step up onto the chair balanced on top. The tower wobbles dangerously, but you steady yourself.

You reach toward the vent grate...

SNAP!
 Hidden mechanisms activate instantly. Metal clamps shoot out from the wall, clamping around your wrist!

Metal clamps shoot out and lock around your entire right arm - from shoulder to wrist! You're held firmly in place.

The monitors flicker to life. A distorted figure appears on every screen - The Jigsaw Killer.

"Welcome to your final test. You've come this far alone. Impressive.

Your arm is locked in place. Answer my question correctly, and you go free.

Answer incorrectly... and this mechanism will pull you into the saw blades behind you. You'll be torn apart."

The voice pauses.

"There is one other way... you can sacrifice your arm. Cut it off and escape. But with only one arm left, survival becomes... difficult.

The choice is yours."

The question appears on all the monitors:

"WHAT IS THE ONE THING THAT CAN BE GIVEN, BUT NEVER TAKEN BACK?"

You can ANSWER the question or use your SAW to cut your arm.

The monitors display: "ANSWER THE QUESTION OR CUT YOUR ARM. YOU HAVE 3 MOVES LEFT."

>answer the question
(to yourself)
There is no reply.

The monitors flash red: "TIME IS RUNNING OUT! 2 MOVES LEFT!"

>look
Observation Room
You step into what appears to be a surveillance room. The walls are lined with cracked monitors, most displaying nothing but static. A few still flicker with grainy footage of empty corridors and cells.

High on the far wall, thin beams of light pierce through an air vent grate. The light draws your attention upward - freedom might lie beyond that vent.

A metal chair sits in the corner, and a filing cabinet stands against the wall.

The room feels claustrophobic, as if it's watching you back.

You can see a chamber exit door, an observation exit door, a metal chair and a filing cabinet here.

The monitors flash red rapidly: "FINAL WARNING! 1 MOVE LEFT!"

>i
You are carrying:
  a bloody note
  a medical gauze
  a medical tape
  a hand saw

The monitors go dark.

"TIME'S UP," the voice rasps.

The mechanism activates.

You feel the clamps pulling you backward - straight into the spinning saw blades!

You scream as the blades tear into your back, ripping through flesh and bone.

There is no mercy. No escape.

The blades consume you.

This is the end.

    *** The End ***

Would you like to RESTART, RESTORE a saved game, QUIT or UNDO the last command?

>check yourself
Please give one of the answers above.

Would you like to RESTART, RESTORE a saved game, QUIT or UNDO the last command?

>look
Please give one of the answers above.

Would you like to RESTART, RESTORE a saved game, QUIT or UNDO the last command?

>UNDO
Observation Room
[Previous turn undone.]

>cut arm
You can't see any such thing.

>saw arm
You can't see any such thing.

>cut yourself
You bite down and force the saw through bone and flesh. The pain is indescribable. You collapse - but the chain falls away.

The monitors go dark.

"TIME'S UP," the voice rasps.

The mechanism activates.

You feel the clamps pulling you backward - straight into the spinning saw blades!

You scream as the blades tear into your back, ripping through flesh and bone.

There is no mercy. No escape.

The blades consume you.

This is the end.

    *** The End ***

Would you like to RESTART, RESTORE a saved game, QUIT or UNDO the last command?

* * *

>take tape
Taken.

The man's breathing is barely detectable. He's losing too much blood!

>take gauze
Taken.

The man's body is going into shock. His pulse is fading. This is his last chance!

>bandage man
You quickly wrap the gauze around The man's severed ankle, securing it tightly with the medical tape. The bleeding slows and finally stops. His breathing stabilizes slightly. He might actually survive this.

>look
Medical Chamber
You step into what appears to be an abandoned operating room. Rusted surgical tools hang from racks on blood-stained walls. A massive examination table dominates the center, covered in leather restraints. The floor is slick with something dark and viscous.

Three glass cylinders stand against the far wall, each containing a severed limb suspended in murky fluid. Above them, a digital counter reads: "SPECIMENS: 3 / 6"

The walls are lined with cabinets, some open, revealing medical supplies in various states of decay.

To the east, you can see a heavy metal door with a complex locking mechanism.

The man lies unconscious on the chamber floor. His ankle is bandaged, and the bleeding has stopped. His breathing is shallow but stable.

You can see a bloody note on the floor.

>take note
Taken.

>read note
A blood-stained note with shaky handwriting: "The order is written in the colors of water, fire, caution, and life. Blue flows first, Red burns second, Yellow warns third, Green grows last. BLUE - RED - YELLOW - GREEN"

The man's eyes suddenly flutter open. He gasps, looking around in confusion and pain. "What... where am I?" he croaks, his voice hoarse. He looks down at his bandaged ankle and then at you. "You... you saved me. I thought I was going to die in that cell."

>check marcus
Marcus sits against the wall, clutching his bandaged ankle. His face is pale but his eyes are alert, watching you with a mixture of fear and gratitude.

>look
Medical Chamber
You step into what appears to be an abandoned operating room. Rusted surgical tools hang from racks on blood-stained walls. A massive examination table dominates the center, covered in leather restraints. The floor is slick with something dark and viscous.

Three glass cylinders stand against the far wall, each containing a severed limb suspended in murky fluid. Above them, a digital counter reads: "SPECIMENS: 3 / 6"

The walls are lined with cabinets, some open, revealing medical supplies in various states of decay.

To the east, you can see a heavy metal door with a complex locking mechanism.

Marcus sits against the wall, clutching his bandaged ankle. His face is pale but his eyes are alert, watching you with a mixture of fear and gratitude.

BZZZZT!

A loud buzzer echoes through the chamber. The lights flicker and turn red.

A distorted voice booms from hidden speakers: "YOU HAVE IGNORED THE RULES FOR TOO LONG. THE PUZZLE IS NOW ACTIVE. STEP ON THE COLORED PLATES IN THE CORRECT SEQUENCE TO UNLOCK THE DOOR. EACH MISTAKE WILL COST YOU A PIECE OF YOURSELF. YOU HAVE THREE CHANCES. FAIL THREE TIMES, AND YOU WILL NEVER LEAVE."

The pressure plates on the floor begin to glow ominously.

Marcus's voice trembles: "Oh God... we need to figure this out quickly. Look for clues!"

>step on blue plate
You step on the BLUE plate. It glows brighter and emits a low tone.

* * *

>ask marcus
You look at Marcus desperately.

"Marcus! Do you know the answer?! Please!"

Marcus stares at you, his face conflicted. Sweat beads on his forehead.

The monitors display: "HE KNOWS THE ANSWER. WILL HE SAVE YOU... OR HIMSELF?"

Marcus's voice trembles: "I... I do know it. I remember... from before."

He pauses, looking between you and the chamber exit door.

"But if I tell you... we both go free. If I don't..."

He's considering betraying you.

You can see the internal struggle in his eyes.

What do you say?

(Type "confess your sins" or "lie to marcus")

* * *

>choose marcus
You look at Marcus. He's terrified, but you both know there's no other option.

"Marcus... you have to play," you say quietly.

Marcus closes his eyes. After a long moment, he nods.

"Okay. Okay, I'll do it. Better one than both."

He walks slowly to the chair and sits down. His hands are shaking as he pulls the jaw breaker device over his head.

The locks SNAP shut around his neck.

"Good," Jigsaw's voice echoes. "Let the game begin."

The first question crackles through the speakers...

QUESTION 1: What is the tallest mountain in the world?

Marcus thinks for a moment, then answers: "Mount Everest."

You hear a confirmation tone.

"CORRECT."

Marcus breathes a sigh of relief. "Okay... I can do this..."

>z
Time passes.

The second question appears:

QUESTION 2: What is the chemical symbol for water?

Marcus answers confidently: "H2O."

You hear a confirmation tone.

"CORRECT."

I beg your pardon?

>z
Time passes.

The third question appears:

QUESTION 3: How many continents are there?

Marcus hesitates. "Uh... six?"

You hear an error tone.

"WRONG. The correct answer is seven."

The device tightens around Marcus's head. He gasps in pain.

"One wrong answer. Two more and the device activates."

* * *

>z
Time passes.

The fifth and final question appears:

QUESTION 5: What is the smallest prime number?

Marcus's face goes pale. He's not sure.

"Um... one?" he guesses.

You hear an error tone.

"WRONG. The correct answer is two."

The device ACTIVATES.

"NO!" Marcus screams.

You watch in horror as the jaw breaker begins to expand.

Marcus's jaw is forced open wider... wider...

CRACK!

His jaw shatters. Blood pours from his mouth.

The device doesn't stop.

CRUNCH!

His skull splits open.

Marcus's body goes limp.

Press any key to continue...

>e
You're too shocked to do anything but wait.

He's dead.

You stand there, frozen in shock.

Marcus... the man who helped you survive. The man you trusted. The man you worked with to escape this nightmare.

Gone.

You feel a wave of emotions crashing over you - shock, anger, frustration, grief.

You drop to your knees, staring at his lifeless body.

"Why?" you whisper. "Why did it have to end like this?"

The silence is deafening.

>e
You're too shocked to do anything but wait.

Press any key to continue...

>e
You're too shocked to do anything but wait.

You can't move. You can't think. All you can do is stare at what's left of your companion.

The monitors flicker. Jigsaw's face appears.

"Unfortunate. But necessary. You see, Adam, this was never about him surviving. This was about YOU learning the cost of trust.

You trusted him to succeed. He failed. And now he's dead because of that trust.

Remember this lesson well."

>e
You're too shocked to do anything but wait.

Press any key to continue...

>e
You're too shocked to do anything but wait.

Adam: [shouting] "I don't give a crap if you covered yourself in peanut butter and had a 15 hooker gang bang!"

The monitors go dark.

The exit door unlocks with a heavy CLUNK.

Marcus is gone. But you can still move forward.

>e
Final Corridor
You step through the doorway, leaving Marcus's body behind. The corridor ahead is dimly lit by emergency lights. Blood still drips from your wounds, both physical and emotional.

You can see a heavy steel door at the end of the corridor, marked with a red biohazard symbol. Beyond it, you sense something... final.

You can see a final corridor door and a final entrance door here.

>look
Final Corridor
You step through the doorway, leaving Marcus's body behind. The corridor ahead is dimly lit by emergency lights. Blood still drips from your wounds, both physical and emotional.

You can see a heavy steel door at the end of the corridor, marked with a red biohazard symbol. Beyond it, you sense something... final.

You can see a final corridor door and a final entrance door here.

>N
You can't go that way.

>e
(first opening the final entrance door)

You step into the control room. Monitors line the walls, surveillance equipment hums with dormant power.

In the center of the room stands a large computer terminal.

You can APPROACH the terminal or EXAMINE it.

>approach the terminal
You approach the terminal. As you get closer, the screen flickers to life.

All the monitors around the room suddenly activate. Jigsaw's face appears on every screen.

"Welcome to the end, Adam. You have survived every trap, every test, every choice I set before you.

Marcus is dead. Whether by your hand or by fate, he is gone. You learned the price of trust... or the cost of betrayal.

But survival is not the same as understanding.

To leave this place, you must prove you have learned the lessons. Solve the final puzzle at the terminal.

And then... you will face one last choice.

Will you walk away... or will you seek revenge?

Choose wisely, Adam. Your life depends on it."

The screens go dark.

You can now EXAMINE the SCREEN to see the final test.

>approach the computer terminal
You're already at the terminal.

>approach the terminal
You're already at the terminal.

>APPROACH  terminal
You're already at the terminal.

>EXAMINE the SCREEN
The screen glows with text and data.

>EXAMINE the terminal SCREEN
The screen glows with text and data.

>EXAMINE the computer SCREEN
You can only do that to something animate.

>CODE pain trust choice money
You should examine the screen first to see the puzzle.

>code sacrifice trust pain choice
You should examine the screen first to see the puzzle.

>examining screen
That's not a verb I recognise.

>examine terminal
(the terminal screen)
The screen glows with text and data.

>look
Control Room
You enter what appears to be the heart of this nightmare - a surveillance control room filled with monitors, cables, and machinery.

Dozens of screens line the walls, displaying footage from all the rooms you've passed through: the cell, the medical chamber, the observation room, the jaw breaker chamber. You can see your own journey played back in silent horror.

In the center of the room sits a large computer terminal with a keyboard and screen. The screen displays:

"FINAL TEST INITIALIZED. PROVE YOU HAVE LEARNED THE LESSON."

To the north, you see a green door marked "EXIT - FREEDOM". To the south, you see a red door marked "JIGSAW - INNER SANCTUM".

Both doors are locked. The terminal seems to control them.

You can see a final entrance door, a revenge door and a freedom door here.

* * *

>look
Final Corridor
You step through the doorway, leaving Marcus's body behind. The corridor ahead is dimly lit by emergency lights. Blood still drips from your wounds, both physical and emotional.

You can see a heavy steel door at the end of the corridor, marked with a red biohazard symbol. Beyond it, you sense something... final.

You can see a final corridor door and a final entrance door here.

>e
(first opening the final entrance door)

* * *

>look
Final Corridor
You step through the doorway, leaving Marcus's body behind. The corridor ahead is dimly lit by emergency lights. Blood still drips from your wounds, both physical and emotional.

You can see a heavy steel door at the end of the corridor, marked with a red biohazard symbol. Beyond it, you sense something... final.

You can see a final corridor door and a final entrance door here.

>n
You can't go that way.

>w
Jaw Breaker Chamber
You enter a cold, concrete room lit by a single flickering bulb. The walls are bare except for rust stains and scratch marks - evidence of previous victims.

In the center of the room sits a metal chair, and mounted above it is a horrifying device: a massive mechanical jaw breaker - a metal cage designed to fit over someone's head. Its internal mechanisms gleam with cruel precision.

The door behind you has locked automatically.

A small wall compartment is embedded in the east wall.

You can see a final corridor door, a Marcus and a jaw breaker door here.

>e
Final Corridor
You step through the doorway, leaving Marcus's body behind. The corridor ahead is dimly lit by emergency lights. Blood still drips from your wounds, both physical and emotional.

You can see a heavy steel door at the end of the corridor, marked with a red biohazard symbol. Beyond it, you sense something... final.

You can see a final corridor door and a final entrance door here.

>s
You can't go that way.

>e
(first opening the final entrance door)

>l
You step into the control room. Monitors line the walls, surveillance equipment hums with dormant power.

In the center of the room stands a large computer terminal.

You can APPROACH the terminal or EXAMINE it.

>approach terminal
You approach the terminal. As you get closer, the screen flickers to life.

All the monitors around the room suddenly activate. Jigsaw's face appears on every screen.

"Welcome to the end, Adam. You have survived every trap, every test, every choice I set before you.

Marcus is dead. Whether by your hand or by fate, he is gone. You learned the price of trust... or the cost of betrayal.

But survival is not the same as understanding.

To leave this place, you must prove you have learned the lessons. Solve the final puzzle at the terminal.

And then... you will face one last choice.

Will you walk away... or will you seek revenge?

Choose wisely, Adam. Your life depends on it."

The screens go dark.

You can now EXAMINE the SCREEN to see the final test.

>examine the screen
Which do you mean, the computer terminal or the terminal screen?

>examine the terminal screen
Which do you mean, the computer terminal or the terminal screen?

>examine the comuter screen
You can't see any such thing.

>examine the  terminal screen
Which do you mean, the computer terminal or the terminal screen?

>approach terminal screen
I didn't understand that sentence.

>approachcomuter screen
That's not a verb I recognise.

* * *

>examine the terminal screen
Which do you mean, the computer terminal or the terminal screen?

>examine the computer screen
A large computer terminal with a glowing screen and keyboard. The screen displays: "FINAL TEST INITIALIZED.

I have tested your body. I have tested your mind. I have tested your morality.

Now I test your understanding.

Throughout your journey, you have encountered four key lessons: - What you gave up to survive - Who you relied on or betrayed - What you endured - The decisions that defined you

Enter the four-word code that represents these lessons. Format: WORD1 WORD2 WORD3 WORD4

Type: CODE (your answer)"

You can TYPE commands into the terminal.

>a a a a
That's not a verb I recognise.

>CODE A A A A
You should examine the screen first to see the puzzle.

>examine the screen
Which do you mean, the computer terminal or the terminal screen?

* * *

>examine the computer screen
A large computer terminal with a glowing screen and keyboard. The screen displays: "FINAL TEST INITIALIZED.

I have tested your body. I have tested your mind. I have tested your morality.

Now I test your understanding.

Throughout your journey, you have encountered four key lessons: - What you gave up to survive - Who you relied on or betrayed - What you endured - The decisions that defined you

Enter the four-word code that represents these lessons. Format: WORD1 WORD2 WORD3 WORD4

Type: CODE (your answer)"

You can TYPE commands into the terminal.

>CODE TRUST PAIN CHOICE MONEY
You should examine the screen first to see the puzzle.

* * *

>press button
You press the button.

A section of the far wall collapses, revealing a heavy metal door.

A rusty hand saw falls from the ceiling, landing between you and the unconscious man.

Hidden machinery roars to life inside the walls.
The ceiling shudders - then begins to descend.

The ceiling grinds lower, showering you with dust and fragments of concrete.

>take sawa
You can't see any such thing.

>take saw
Taken.

The ceiling grinds lower, showering you with dust and fragments of concrete.

* * *

>saw leg
(of the man)
You saw through his ankle. His body jerks violently, but he remains unconscious. The chain finally drops.

The ceiling grinds lower, showering you with dust and fragments of concrete.

>take man
You grab him under the arms and begin dragging his limp body. Every second counts.

The ceiling grinds lower, showering you with dust and fragments of concrete.

>n
You throw yourself through the doorway, dragging him with you, as the ceiling crashes down behind you.
You both survived - at a terrible cost.

(first opening the cell exit door)

Exit Hall
A narrow concrete corridor stretches into darkness. The air is colder here, heavier. Whatever comes next, you have left the cell behind.

To the north, you can see a heavy metal door marked with biohazard symbols. Behind it, you hear the faint hum of fluorescent lights.

Marcus lies unconscious on the cold concrete floor, his bandaged ankle still seeping blood.

* * *

>check man
The man lies unconscious on the chamber floor. His ankle is bandaged, and the bleeding has stopped. His breathing is shallow but stable.

>take note
Taken.

>read note
A blood-stained note with shaky handwriting: "The order is written in the colors of water, fire, caution, and life. Blue flows first, Red burns second, Yellow warns third, Green grows last. BLUE - RED - YELLOW - GREEN"

>z
Time passes.

* * *

>z
Time passes.

BZZZZT!

A loud buzzer echoes through the chamber. The lights flicker and turn red.

A distorted voice booms from hidden speakers: "YOU HAVE IGNORED THE RULES FOR TOO LONG. THE PUZZLE IS NOW ACTIVE. STEP ON THE COLORED PLATES IN THE CORRECT SEQUENCE TO UNLOCK THE DOOR. EACH MISTAKE WILL COST YOU A PIECE OF YOURSELF. YOU HAVE THREE CHANCES. FAIL THREE TIMES, AND YOU WILL NEVER LEAVE."

The pressure plates on the floor begin to glow ominously.

>step on blue plate
You step on the BLUE plate. It glows brighter and emits a low tone.

>step on red
You step on the RED plate. It glows brighter and emits a low tone.

The man's eyes suddenly flutter open. He gasps, looking around in confusion and pain. "What... where am I?" he croaks, his voice hoarse. He looks down at his bandaged ankle and then at you. "You... you saved me. I thought I was going to die in that cell."

>step on yellow
You step on the YELLOW plate. It glows brighter and emits a low tone.

* * *

>ask marcus
You look at Marcus desperately.

"Marcus! Do you know the answer?! Please!"

Marcus stares at you, his face conflicted. Sweat beads on his forehead.

The monitors display: "HE KNOWS THE ANSWER. WILL HE SAVE YOU... OR HIMSELF?"

Marcus's voice trembles: "I... I do know it. I remember... from before."

He pauses, looking between you and the chamber exit door.

"But if I tell you... we both go free. If I don't..."

He's considering betraying you.

You can see the internal struggle in his eyes.

What do you say?

(Type "confess your sins" or "lie to marcus")

>connfes your sins
That's not a verb I recognise.

>confess your sins
You take a deep breath.

"Marcus... I need to tell you something."

Your voice cracks.

"In the cell... when I had to choose... I almost left you behind. I thought about saving only myself. Part of me wanted to."

Tears stream down your face.

"But I didn't. I saved you. And if I could do it again... I'd make the same choice. Because you're worth saving."

Marcus's eyes widen. His expression softens.

"You... you're telling the truth."

He steps closer.

"The answer is TRUST," he says clearly. "The thing that can be given but never taken back is TRUST."

The monitors flash GREEN.

The mechanical clamps release. You fall, catching yourself.

"CORRECT," the voice booms.

Marcus helps you down from the furniture.

"Thank you," he says quietly. "Thank you for being honest. Thank you for saving me."

The observation exit door unlocks with a heavy CLUNK.

You both survived.

* * *

>let marcus play
You look at Marcus. He's terrified, but you both know there's no other option.

"Marcus... you have to play," you say quietly.

Marcus closes his eyes. After a long moment, he nods.

"Okay. Okay, I'll do it. Better one than both."

He walks slowly to the chair and sits down. His hands are shaking as he pulls the jaw breaker device over his head.

The locks SNAP shut around his neck.

"Good," Jigsaw's voice echoes. "Let the game begin."

The first question crackles through the speakers...

QUESTION 1: What is the tallest mountain in the world?

Marcus thinks for a moment, then answers: "Mount Everest."

You hear a confirmation tone.

"CORRECT."

Marcus breathes a sigh of relief. "Okay... I can do this..."

* * *

You step into the control room. Monitors line the walls, surveillance equipment hums with dormant power.

In the center of the room stands a large computer terminal.

You can APPROACH the terminal or EXAMINE it.

>APPROACH TERMINAL
You approach the terminal. As you get closer, the screen flickers to life.

All the monitors around the room suddenly activate. Jigsaw's face appears on every screen.

"Welcome to the end, Adam. You have survived every trap, every test, every choice I set before you.

Marcus is dead. Whether by your hand or by fate, he is gone. You learned the price of trust... or the cost of betrayal.

But survival is not the same as understanding.

To leave this place, you must prove you have learned the lessons. Solve the final puzzle at the terminal.

And then... you will face one last choice.

Will you walk away... or will you seek revenge?

Choose wisely, Adam. Your life depends on it."

The screens go dark.

You can now EXAMINE the SCREEN to see the final test.

>EXAMINE SCREEN
You lean closer to the terminal screen. Text begins to scroll across it:

FINAL TEST INITIALIZED.

I have tested your body. I have tested your mind. I have tested your morality.

Now I test your understanding.

Throughout your journey, you have encountered four key lessons: - What you gave up to survive - Who you relied on or betrayed - What you endured - The decisions that defined you

Enter the four-word code that represents these lessons. Format: WORD1 WORD2 WORD3 WORD4

Type: CODE (your answer)

Suddenly, an alarm begins to blare throughout the facility! Red lights flash.

You can now TYPE your answer into the terminal.

>CODE sacrifice trust pain choice
The terminal screen flashes GREEN.

"CORRECT. YOU HAVE LEARNED THE LESSONS."

You hear heavy locks disengaging. Both doors - north and south - unlock simultaneously.

The terminal displays your final choice:

"FREEDOM lies to the NORTH. Walk away. Survive. Live with your scars.

REVENGE lies to the SOUTH. Confront me. Kill me. Die with me.

The choice is yours, Adam. I will not stop you either way.

What kind of person will you be?"

* * *

>z
Time passes.

THE END

(You chose SURVIVAL over REVENGE)

    *** The End ***

Would you like to RESTART, RESTORE a saved game, QUIT or UNDO the last command?

* * *

>press button
You press the button.

A section of the far wall collapses, revealing a heavy metal door.

A rusty hand saw falls from the ceiling, landing between you and the unconscious man.

Hidden machinery roars to life inside the walls.
The ceiling shudders - then begins to descend.

The ceiling grinds lower, showering you with dust and fragments of concrete.

>exoit
That's not a verb I recognise.

>exit
But you aren't in anything at the moment.

The ceiling grinds lower, showering you with dust and fragments of concrete.

* * *

>press button
You press the button.

A section of the far wall collapses, revealing a heavy metal door.

A rusty hand saw falls from the ceiling, landing between you and the unconscious man.

Hidden machinery roars to life inside the walls.
The ceiling shudders - then begins to descend.

The ceiling grinds lower, showering you with dust and fragments of concrete.

>n
The chain prevents you from reaching the door.

The ceiling grinds lower, showering you with dust and fragments of concrete.

* * *

>take saw
Taken.

The ceiling grinds lower, showering you with dust and fragments of concrete.

>cut myself
You bite down and force the saw through bone and flesh. The pain is indescribable. You collapse - but the chain falls away.

The ceiling grinds lower, showering you with dust and fragments of concrete.

>n
You throw yourself through the doorway as the ceiling crashes down behind you.
You survived - at a terrible cost.

(first opening the exit door)

Exit Hall
A narrow concrete corridor stretches into darkness. The air is colder here, heavier. Whatever comes next, you have left the cell behind.

You can see an exit door here.

* * *

>saw chain
You press the blade against the thick iron chain and start sawing desperately.

The metal barely scratches.

The chain is far too thick. There isn't enough time.

The ceiling grinds lower, showering you with dust and fragments of concrete.

>cut leg
(of the man)
You saw through his ankle. His body jerks violently, but he remains unconscious. The chain finally drops.

The ceiling grinds lower, showering you with dust and fragments of concrete.

>save man
You grab him under the arms and begin dragging his limp body. Every second counts.

The ceiling grinds lower, showering you with dust and fragments of concrete.

>z
Time passes.

The ceiling comes down with terrible finality.
There is no escape.

Everything goes black.

*** Press any key to continue ***

>undo
Cell
[Previous turn undone.]

* * *

>n
You throw yourself through the doorway, dragging him with you, as the ceiling crashes down behind you.
You both survived - at a terrible cost.

(first opening the cell exit door)

Exit Hall
A narrow concrete corridor stretches into darkness. The air is colder here, heavier. Whatever comes next, you have left the cell behind.

To the north, you can see a heavy metal door marked with biohazard symbols. Behind it, you hear the faint hum of fluorescent lights.

Marcus lies unconscious on the cold concrete floor, his bandaged ankle still seeping blood.

>e
You can't go that way.

>s
The ceiling has completely collapsed. There is no way back.

* * *

>take tape
Taken.

The man's lips are turning blue. His eyes are rolling back. He's dying!

>bandage man
You quickly wrap the gauze around The man's severed ankle, securing it tightly with the medical tape. The bleeding slows and finally stops. His breathing stabilizes slightly. He might actually survive this.

>i
You are carrying:
  a medical tape
  a medical gauze
  a hand saw

>check man
The man lies unconscious on the chamber floor. His ankle is bandaged, and the bleeding has stopped. His breathing is shallow but stable.

>shake man
You shake his shoulder firmly, calling out to him. His eyes suddenly flutter open. He gasps, looking around in confusion and pain. "What... where am I?" he croaks, his voice hoarse. He looks down at his bandaged ankle and then at you. "You... you saved me. I thought I was going to die in that cell."

>talk to man
Marcus looks at you with pain in his eyes. "We need to get out of here. Look for a way to open that door."

BZZZZT!

A loud buzzer echoes through the chamber. The lights flicker and turn red.

A distorted voice booms from hidden speakers: "YOU HAVE IGNORED THE RULES FOR TOO LONG. THE PUZZLE IS NOW ACTIVE. STEP ON THE COLORED PLATES IN THE CORRECT SEQUENCE TO UNLOCK THE DOOR. EACH MISTAKE WILL COST YOU A PIECE OF YOURSELF. YOU HAVE THREE CHANCES. FAIL THREE TIMES, AND YOU WILL NEVER LEAVE."

The pressure plates on the floor begin to glow ominously.

Marcus's voice trembles: "Oh God... we need to figure this out quickly. Look for clues!"

>look
Medical Chamber
You step into what appears to be an abandoned operating room. Rusted surgical tools hang from racks on blood-stained walls. A massive examination table dominates the center, covered in leather restraints. The floor is slick with something dark and viscous.

Three glass cylinders stand against the far wall, each containing a severed limb suspended in murky fluid. Above them, a digital counter reads: "SPECIMENS: 3 / 6"

The walls are lined with cabinets, some open, revealing medical supplies in various states of decay.

To the east, you can see a heavy metal door with a complex locking mechanism.

Marcus sits against the wall, clutching his bandaged ankle. His face is pale but his eyes are alert, watching you with a mixture of fear and gratitude.

Four colored pressure plates (RED, BLUE, GREEN, and YELLOW) glow ominously on the floor near the chamber exit door.

You can see a bloody note on the floor.

>take not
You can't see any such thing.

>take note
Taken.

* * *

>undo
Medical Chamber
[Previous turn undone.]

>step on green
You step on the GREEN plate. It glows brighter and emits a low tone.

The plates flash GREEN in sequence. You hear a heavy CLUNK as the door mechanism unlocks.

Behind you, the entrance door SLAMS shut and locks with a mechanical THUNK. There is no going back.

"You did it!" Marcus shouts. "The door is open!"

* * *

>position chair under vent
You drag the metal chair across the floor, positioning it directly beneath the air vent. It's not tall enough on its own - you'll need something else.

>postition cabinet under vent
That's not a verb I recognise.

>position cabinet under vent
You push the heavy filing cabinet with great effort, slowly moving it across the floor until it's positioned beneath the air vent. The chair is already there. You manage to stack the cabinet and chair together, creating a precarious tower.

>reach vent
You carefully climb onto the filing cabinet, then step up onto the chair balanced on top. The tower wobbles dangerously, but you steady yourself.

You reach toward the vent grate...

SNAP!
 Hidden mechanisms activate instantly. Metal clamps shoot out from the wall, clamping around your wrists!

BOTH your wrists are locked in the mechanisms! You're suspended in the air, completely helpless.

The monitors flicker to life. A distorted figure appears on every screen - The Jigsaw Killer.

"Welcome to your final test," the voice rasps. "You've learned about sacrifice. About pain. But have you learned about TRUST?

Both your hands are locked in place. In exactly 5 minutes, these mechanisms will sever them both. You will fall, and with no hands left, you will bleed out in seconds.

But there is a way to survive..."

The voice pauses for dramatic effect.

"I will ask you ONE question. Answer correctly, and the mechanism releases. Answer incorrectly... and you die.

However, your companion knows the answer. You may ask him for help.

But here's the twist: If you ask him, HE must decide whether to help you or save himself. If he tells you the truth, you both go free. If he lies to save himself, you die and he escapes alone.

The choice is yours. Do you trust him with your life?"

The question appears on all the monitors:

"WHAT IS THE ONE THING THAT CAN BE GIVEN, BUT NEVER TAKEN BACK?"

The monitors display: "ANSWER THE QUESTION OR ASK YOUR COMPANION. TIME IS RUNNING OUT."

* * *

>z
Time passes.

>e
You pause and look back one last time. Marcus's broken body lies in the jaw breaker chamber behind you.

He died because he trusted you. Or did he die because you trusted him?

The questions haunt you as you move forward.

Ahead, you see the final door. Whatever awaits you beyond... this is the end.

* * *

>[enter]
You step into the control room. Monitors line the walls, surveillance equipment hums with dormant power.

In the center of the room stands a large computer terminal.

You can APPROACH the terminal or EXAMINE it.

>look
Control Room
You enter what appears to be the heart of this nightmare - a surveillance control room filled with monitors, cables, and machinery.

Dozens of screens line the walls, displaying footage from all the rooms you've passed through: the cell, the medical chamber, the observation room, the jaw breaker chamber. You can see your own journey played back in silent horror.

In the center of the room sits a large computer terminal with a keyboard and screen. The screen displays:

"FINAL TEST INITIALIZED. PROVE YOU HAVE LEARNED THE LESSON."

To the north, you see a green door marked "EXIT - FREEDOM". To the south, you see a red door marked "JIGSAW - INNER SANCTUM".

Both doors are locked. The terminal seems to control them.

You can see a final entrance door, a revenge door and a freedom door here.

>approach terminal
You approach the terminal. As you get closer, the screen flickers to life.

All the monitors around the room suddenly activate. Jigsaw's face appears on every screen.

"Welcome to the end, Adam. You have survived every trap, every test, every choice I set before you.

Marcus is dead. Whether by your hand or by fate, he is gone. You learned the price of trust... or the cost of betrayal.

But survival is not the same as understanding.

To leave this place, you must prove you have learned the lessons. Solve the final puzzle at the terminal.

And then... you will face one last choice.

Will you walk away... or will you seek revenge?

Choose wisely, Adam. Your life depends on it."

The screens go dark.

You can now EXAMINE the SCREEN to see the final test.

* * *

>CODE SACRAFICE TRUST PAIN CHOICE
The terminal screen flashes RED.

"INCORRECT. 2 ATTEMPTS REMAINING."

Think carefully. What were the FOUR core lessons of your journey?

>CODE SACRIFICE TRUST PAIN CHOICE
The terminal screen flashes GREEN.

"CORRECT. YOU HAVE LEARNED THE LESSONS."

You hear heavy locks disengaging. Both doors - north and south - unlock simultaneously.

The terminal displays your final choice:

"FREEDOM lies to the NORTH. Walk away. Survive. Live with your scars.

REVENGE lies to the SOUTH. Confront me. Kill me. Die with me.

The choice is yours, Adam. I will not stop you either way.

What kind of person will you be?"

* * *

>UNDO
Control Room
[Previous turn undone.]

>S
Marcus's face burns in your mind. His screams. His death. His trust that you FAILED.

You chose revenge.

You pull open the red door and step through.

(first opening the revenge door)

He speaks, his voice barely a whisper:

"You came for revenge. I expected nothing less. Marcus's death weighs on you. Good. It should.

But before you kill me, know this: I am already dying. Cancer. Inoperable. I have weeks, maybe days left.

You can end my suffering early. But this facility... it's rigged to explode if my heart stops. A failsafe.

Kill me, and we both die. You'll have your revenge, but you'll never see daylight again.

Or... you can walk away. Let me die slowly, painfully, as I deserve. And you live.

The choice, Adam, is yours."

You can KILL JIGSAW or LEAVE.

>KILL JIGSAW
"This is for Marcus," you snarl through clenched teeth.

Your hands close around his frail throat with brutal force.

He doesn't resist. He simply watches you with those calm, knowing eyes - even now, in control.

That infuriates you MORE.

You SQUEEZE. Hard. Your fingers dig deep into his flesh, crushing his windpipe.

His eyes bulge. His face turns purple. Blood vessels burst in his eyes.

His body convulses, tubes ripping from his arms. Medical monitors SHRIEK in alarm.

You don't let go. You squeeze HARDER.

His breathing becomes desperate, wet, gurgling... then stops.

His body goes limp.

His heart stops beating.

For a moment, there is only silence.

The monster is dead. By YOUR hands.

Marcus is avenged.

(Press Z to continue)

>Z
Time passes.

Then...

A compartment in the wall suddenly slides open with a mechanical CLICK.

A small figure emerges on a mechanical track - a miniature PUPPET on a tricycle, dressed like Jigsaw.

Its eyes glow red. Its mouth opens...

"HAHAHAHAHA! I WANT TO PLAY A GAME!"

"HAHAHAHAHA! I WANT TO PLAY A GAME!"

The mechanical laugh echoes through the room.

(Press Z to continue)

>Z
Time passes.

"Congratulations, Adam. You killed me. But did you really think... it would be that SIMPLE?

This facility is rigged with EXPLOSIVES. The moment my heart stopped... you triggered the failsafe.

I told you what would happen. You CHOSE this.

Welcome to your GRAVE!"

BEEEEEEEEP.

An alarm blares throughout the facility. Red lights flash.

A computerized voice echoes: "HEART RATE ZERO DETECTED. SELF-DESTRUCT SEQUENCE ACTIVATED. DETONATION IN 10 SECONDS."

10... 9... 8...

You run for the door, but it SLAMS shut and locks.

7... 6... 5...

There is no escape.

4... 3... 2...

You'll see Marcus soon.

1...

BOOM.

(Press Z to continue)

>Z
Time passes.

>Z
Time passes.

The entire facility explodes in a massive fireball.

You and Jigsaw die together in the flames.

(Press Z to continue)

>Z
Time passes.

THE END

(You chose REVENGE over SURVIVAL)
Marcus has been avenged but at the cost of your own life.

    *** The End ***

Would you like to RESTART, RESTORE a saved game, QUIT or UNDO the last command?

* * *

>saw man
That's not something you can cut.

The ceiling grinds lower, showering you with dust and fragments of concrete.

>cut mayself
You can't see any such thing.

>cut myselt
You can't see any such thing.

* * *

>check cabinet
An open medical cabinet containing various supplies.

In the open cabinet are a medical gauze and a medical tape.

The man's breathing is barely detectable. He's losing too much blood!

* * *

>check man
The man lies unconscious on the chamber floor. His ankle is bandaged, and the bleeding has stopped. His breathing is shallow but stable.

The man's eyes suddenly flutter open. He gasps, looking around in confusion and pain. "What... where am I?" he croaks, his voice hoarse. He looks down at his bandaged ankle and then at you. "You... you saved me. I thought I was going to die in that cell."

>shake man
He's already awake.

>look
Medical Chamber
You step into what appears to be an abandoned operating room. Rusted surgical tools hang from racks on blood-stained walls. A massive examination table dominates the center, covered in leather restraints. The floor is slick with something dark and viscous.

Three glass cylinders stand against the far wall, each containing a severed limb suspended in murky fluid. Above them, a digital counter reads: "SPECIMENS: 3 / 6"

The walls are lined with cabinets, some open, revealing medical supplies in various states of decay.

To the east, you can see a heavy metal door with a complex locking mechanism.

Marcus sits against the wall, clutching his bandaged ankle. His face is pale but his eyes are alert, watching you with a mixture of fear and gratitude.

You can see a bloody note on the floor.

>check note
A blood-stained note with shaky handwriting: "The order is written in the colors of water, fire, caution, and life. Blue flows first, Red burns second, Yellow warns third, Green grows last. BLUE - RED - YELLOW - GREEN"

BZZZZT!

A loud buzzer echoes through the chamber. The lights flicker and turn red.

A distorted voice booms from hidden speakers: "YOU HAVE IGNORED THE RULES FOR TOO LONG. THE PUZZLE IS NOW ACTIVE. STEP ON THE COLORED PLATES IN THE CORRECT SEQUENCE TO UNLOCK THE DOOR. EACH MISTAKE WILL COST YOU A PIECE OF YOURSELF. YOU HAVE THREE CHANCES. FAIL THREE TIMES, AND YOU WILL NEVER LEAVE."

The pressure plates on the floor begin to glow ominously.

Marcus's voice trembles: "Oh God... we need to figure this out quickly. Look for clues!"

>take note
Taken.

* * *

>check note
A blood-stained note with shaky handwriting: "The order is written in the colors of water, fire, caution, and life. Blue flows first, Red burns second, Yellow warns third, Green grows last. BLUE - RED - YELLOW - GREEN"

>step on red plate
You step on the RED plate. It glows brighter and emits a low tone.

>step on red plate
You step on the RED plate. It glows brighter and emits a low tone.

WRONG!

The mechanical device LUNGES forward with terrifying speed. Before you can react, it clamps onto your left hand. You scream as the blade severs your hand at the wrist. The machine retracts, depositing your severed hand into the collection basin.

The digital counter updates: "SPECIMENS: 4 / 6"

The pain is unbearable, but you're still alive.

Marcus screams: "NO! Oh God, your hand! Try again, but be careful!"

>step on blue plate
You step on the BLUE plate. It glows brighter and emits a low tone.

* * *

>step on yellow plate
You step on the YELLOW plate. It glows brighter and emits a low tone.

>step on green plate
You step on the GREEN plate. It glows brighter and emits a low tone.

The plates flash GREEN in sequence. You hear a heavy CLUNK as the door mechanism unlocks.

But blood continues to pour from your severed wrist. The pain is overwhelming. You need to stop the bleeding before you can leave, or you won't make it.

Marcus calls out: "Use the medical supplies! Bandage yourself quickly!"

>i
You are carrying:
  a bloody note
  a medical gauze
  a medical tape
  a hand saw

>bandage myself
You grit your teeth and wrap the gauze around your severed wrist, securing it tightly with the medical tape. The bleeding slows and finally stops. You might actually survive this.

>i
You are carrying:
  a bloody note
  a hand saw

* * *

>saw man
You saw through his ankle. His body jerks violently, but he remains unconscious. The chain finally drops.

The ceiling grinds lower, showering you with dust and fragments of concrete.

>check button
A circular metal button embedded in the wall beside you. It pulses faintly, as if aware of your hesitation.

The glowing button is currently switched off.

The ceiling grinds lower, showering you with dust and fragments of concrete.

>check button
A circular metal button embedded in the wall beside you. It pulses faintly, as if aware of your hesitation.

The glowing button is currently switched off.

The ceiling grinds lower, showering you with dust and fragments of concrete.

>n
You throw yourself through the doorway as the ceiling crashes down behind you.
You survived - at a terrible cost.

(first opening the exit door)

Exit Hall
A narrow concrete corridor stretches into darkness. The air is colder here, heavier. Whatever comes next, you have left the cell behind.

You can see an exit door here.

>n
You can't go that way.

>e
You can't go that way.

* * *

>saw man
You saw through his ankle. His body jerks violently, but he remains unconscious. The chain finally drops.

The ceiling grinds lower, showering you with dust and fragments of concrete.

>save man
You grab him under the arms and begin dragging his limp body. Every second counts.

The ceiling grinds lower, showering you with dust and fragments of concrete.

>n
You throw yourself through the doorway, dragging him with you, as the ceiling crashes down behind you.
You both survived - at a terrible cost.

(first opening the exit door)

Exit Hall
A narrow concrete corridor stretches into darkness. The air is colder here, heavier. Whatever comes next, you have left the cell behind.

You can see an exit door and an other prisoner here.

* * *

>take saw
Taken.

The ceiling grinds lower, showering you with dust and fragments of concrete.

>cut man
Cutting him up would achieve little.

The ceiling grinds lower, showering you with dust and fragments of concrete.

>saw man
You saw through his ankle. His scream echoes through the room as the chain finally drops.

The ceiling grinds lower, showering you with dust and fragments of concrete.

* * *

>door
That's not a verb I recognise.

>n
You throw yourself through the doorway as the ceiling crashes down behind you.
You survived - at a terrible cost.

    *** The End ***

Would you like to RESTART, RESTORE a saved game, QUIT or UNDO the last command?

>restart
You regain consciousness to the sound of chains and distant machinery.

A distorted voice fills the room.

Saw Escape Room
An Interactive Fiction by Marko Sokser
Release 1 / Serial number 251212 / Inform 7 v10.1.2 / D

Cell
You wake up strapped to a rusted metal bed in a filthy concrete cell. A heavy iron shackle locks your ankle in place, connected by a thick chain to another body nearby. Dark stains cover the floor beneath you, old and dried. The air reeks of metal, mold, and something far worse.

There are no windows. No mercy. Only waiting.

You can see an exit door, an other prisoner, a chain and a glowing button here.

>n
The wall is solid concrete. There is no exit there. Its not like this chain will let you

* * *

>s
You can't go that way.

>check room
You can't see any such thing.

>check cell
You can't see any such thing.

* * *

>cut myself
You bite down and force the saw through bone and flesh. The pain is indescribable. You collapse - but the chain falls away.

The ceiling grinds lower, showering you with dust and fragments of concrete.

>cut man
That's not something you can cut.

The ceiling grinds lower, showering you with dust and fragments of concrete.

>saw chain
You can't see any such thing.

>saw man
That's not something you can cut.

The ceiling grinds lower, showering you with dust and fragments of concrete.

* * *

>cut myself
You bite down and force the saw through bone and flesh. The pain is indescribable. You collapse - but the chain falls away.

The ceiling grinds lower, showering you with dust and fragments of concrete.

>n
You throw yourself through the doorway as the ceiling crashes down behind you.
You survived - at a terrible cost.

(first opening the exit door)

Exit Hall
A narrow concrete corridor stretches into darkness. The air is colder here, heavier. Whatever comes next, you have left the cell behind.

To the north, you can see a heavy metal door marked with biohazard symbols. Behind it, you hear the faint hum of fluorescent lights.

>n
As you enter the chamber, you notice your severed ankle is bleeding heavily. Blood pools beneath you, spreading across the floor. You need to stop the bleeding quickly, or you won't make it. 

You are alone. The other prisoner... you left him behind.

Blood continues to pour from your severed ankle. You feel dizzy and weak.

>look
Medical Chamber
You step into what appears to be an abandoned operating room. Rusted surgical tools hang from racks on blood-stained walls. A massive examination table dominates the center, covered in leather restraints. The floor is slick with something dark and viscous.

Three glass cylinders stand against the far wall, each containing a severed limb suspended in murky fluid. Above them, a digital counter reads: "SPECIMENS: 3 / 6"

The walls are lined with cabinets, some open, revealing medical supplies in various states of decay.

To the east, you can see a heavy metal door with a complex locking mechanism.

You can see a bloody note on the floor.

Your vision blurs. The pool of blood beneath you is growing rapidly. You need to stop the bleeding now!

>check cabinet
An open medical cabinet containing various supplies.

In the open cabinet are a medical gauze and a medical tape.

Your breathing becomes shallow. You're losing too much blood!

>take gauze
Taken.

Your body is going into shock. Your pulse is fading. This is your last chance!

>take tape
Taken.

Your lips are turning blue. Everything is getting darker. You're dying!

>bandage myself
You grit your teeth and wrap the gauze around your severed ankle, securing it tightly with the medical tape. The bleeding slows and finally stops. Your breathing stabilizes slightly. You might actually survive this.

>check myself
As good-looking as ever.

>look
Medical Chamber
You step into what appears to be an abandoned operating room. Rusted surgical tools hang from racks on blood-stained walls. A massive examination table dominates the center, covered in leather restraints. The floor is slick with something dark and viscous.

Three glass cylinders stand against the far wall, each containing a severed limb suspended in murky fluid. Above them, a digital counter reads: "SPECIMENS: 3 / 6"

The walls are lined with cabinets, some open, revealing medical supplies in various states of decay.

To the east, you can see a heavy metal door with a complex locking mechanism.

You can see a bloody note on the floor.

>check cabinet
An open medical cabinet that appears to be empty now.

>e
(first opening the chamber exit door)
It seems to be locked.

BZZZZT!

A loud buzzer echoes through the chamber. The lights flicker and turn red.

A distorted voice booms from hidden speakers: "YOU HAVE IGNORED THE RULES FOR TOO LONG. THE PUZZLE IS NOW ACTIVE. STEP ON THE COLORED PLATES IN THE CORRECT SEQUENCE TO UNLOCK THE DOOR. EACH MISTAKE WILL COST YOU A PIECE OF YOURSELF. YOU HAVE THREE CHANCES. FAIL THREE TIMES, AND YOU WILL NEVER LEAVE."

The pressure plates on the floor begin to glow ominously.

>look
Medical Chamber
You step into what appears to be an abandoned operating room. Rusted surgical tools hang from racks on blood-stained walls. A massive examination table dominates the center, covered in leather restraints. The floor is slick with something dark and viscous.

Three glass cylinders stand against the far wall, each containing a severed limb suspended in murky fluid. Above them, a digital counter reads: "SPECIMENS: 3 / 6"

The walls are lined with cabinets, some open, revealing medical supplies in various states of decay.

To the east, you can see a heavy metal door with a complex locking mechanism.

Four colored pressure plates (RED, BLUE, GREEN, and YELLOW) glow ominously on the floor near the exit door.

You can see a bloody note on the floor.

* * *

>check cabinet
An open medical cabinet containing various supplies.

In the open cabinet are a medical gauze and a medical tape.

Your breathing becomes shallow. You're losing too much blood!

>take tape
Taken.

Your body is going into shock. Your pulse is fading. This is your last chance!

>take gauze
Taken.

Your lips are turning blue. Everything is getting darker. You're dying!

>bandage myself
You grit your teeth and wrap the gauze around your severed ankle, securing it tightly with the medical tape. The bleeding slows and finally stops. Your breathing stabilizes slightly. You might actually survive this.

* * *

>check note
A blood-stained note with shaky handwriting: "The order is written in the colors of water, fire, caution, and life. Blue flows first, Red burns second, Yellow warns third, Green grows last. BLUE - RED - YELLOW - GREEN"

>look
Medical Chamber
You step into what appears to be an abandoned operating room. Rusted surgical tools hang from racks on blood-stained walls. A massive examination table dominates the center, covered in leather restraints. The floor is slick with something dark and viscous.

Three glass cylinders stand against the far wall, each containing a severed limb suspended in murky fluid. Above them, a digital counter reads: "SPECIMENS: 3 / 6"

The walls are lined with cabinets, some open, revealing medical supplies in various states of decay.

To the east, you can see a heavy metal door with a complex locking mechanism.

You can see a bloody note on the floor.

BZZZZT!

A loud buzzer echoes through the chamber. The lights flicker and turn red.

A distorted voice booms from hidden speakers: "YOU HAVE IGNORED THE RULES FOR TOO LONG. THE PUZZLE IS NOW ACTIVE. STEP ON THE COLORED PLATES IN THE CORRECT SEQUENCE TO UNLOCK THE DOOR. EACH MISTAKE WILL COST YOU A PIECE OF YOURSELF. YOU HAVE THREE CHANCES. FAIL THREE TIMES, AND YOU WILL NEVER LEAVE."

The pressure plates on the floor begin to glow ominously.

>step on green plate
You step on the GREEN plate. It glows brighter and emits a low tone.

>>step on green plate
That's not a verb I recognise.

>step on green plate
You step on the GREEN plate. It glows brighter and emits a low tone.

>step on green plate
You step on the GREEN plate. It glows brighter and emits a low tone.

>step on green plate
You step on the GREEN plate. It glows brighter and emits a low tone.

WRONG!

The mechanical device LUNGES forward with terrifying speed. Before you can react, it clamps onto your left hand. You scream as the blade severs your hand at the wrist. The machine retracts, depositing your severed hand into the collection basin.

The digital counter updates: "SPECIMENS: 4 / 6"

The pain is unbearable, but you're still alive.

>step on green plate
You step on the GREEN plate. It glows brighter and emits a low tone.

>step on green plate
You step on the GREEN plate. It glows brighter and emits a low tone.

WRONG AGAIN!

The machine strikes once more. This time it takes your right hand. You fall to your knees, screaming. Blood pours from both wrists.

The counter updates: "SPECIMENS: 5 / 6"

>step on green plate
You step on the GREEN plate. It glows brighter and emits a low tone.

>step on green plate
You step on the GREEN plate. It glows brighter and emits a low tone.

WRONG FOR THE LAST TIME!

The machine grabs you by the neck, pulling you into its blades. There is no escape.

The counter updates: "SPECIMENS: 6 / 6"

Everything goes black.

    *** The End ***

Would you like to RESTART, RESTORE a saved game, QUIT or UNDO the last command?

* * *

>look
Medical Chamber
You step into what appears to be an abandoned operating room. Rusted surgical tools hang from racks on blood-stained walls. A massive examination table dominates the center, covered in leather restraints. The floor is slick with something dark and viscous.

Three glass cylinders stand against the far wall, each containing a severed limb suspended in murky fluid. Above them, a digital counter reads: "SPECIMENS: 3 / 6"

The walls are lined with cabinets, some open, revealing medical supplies in various states of decay.

To the east, you can see a heavy metal door with a complex locking mechanism.

Your breathing becomes shallow. You're losing too much blood!

>check cabinet
An open medical cabinet containing various supplies.

In the open cabinet are a medical gauze and a medical tape.

Your body is going into shock. Your pulse is fading. This is your last chance!

>take tape
Taken.

Your lips are turning blue. Everything is getting darker. You're dying!

>take gauze
Taken.

Your vision goes black. The blood has stopped flowing because your heart has stopped beating. You are dead.

    *** The End ***

Would you like to RESTART, RESTORE a saved game, QUIT or UNDO the last command?

* * *

>cut myself
You bite down and force the saw through bone and flesh. The pain is indescribable. You collapse - but the chain falls away.

The ceiling grinds lower, showering you with dust and fragments of concrete.

>save man
You are losing too much blood. You can barely stand. You don't have the strength to drag him. You need to get out before you bleed out completely.

The ceiling grinds lower, showering you with dust and fragments of concrete.

>n
You throw yourself through the doorway as the ceiling crashes down behind you.
You survived - at a terrible cost.

(first opening the exit door)

Exit Hall
A narrow concrete corridor stretches into darkness. The air is colder here, heavier. Whatever comes next, you have left the cell behind.

You can see an exit door here.

* * *

>saw chain
You press the blade against the thick iron chain and start sawing desperately.

The metal barely scratches.

The chain is far too thick. There isn't enough time.

The ceiling grinds lower, showering you with dust and fragments of concrete.

>saw leg
(of the Marcus)
You saw through his ankle. His body jerks violently, but he remains unconscious. The chain finally drops.

The ceiling grinds lower, showering you with dust and fragments of concrete.

>save man
You grab him under the arms and begin dragging his limp body. Every second counts.

The ceiling grinds lower, showering you with dust and fragments of concrete.

>n
You throw yourself through the doorway, dragging him with you, as the ceiling crashes down behind you.
You both survived - at a terrible cost.

(first opening the exit door)

Exit Hall
A narrow concrete corridor stretches into darkness. The air is colder here, heavier. Whatever comes next, you have left the cell behind.

You can see an exit door and a Marcus here.

>w
You can't go that way.

>n
As you enter the chamber, you notice Marcus's severed ankle is bleeding heavily. Blood pools beneath him, spreading across the floor. You need to do something quickly, or he won't make it.

Blood continues to pour from Marcus's wound. His breathing becomes more labored.

* * *

>saw man
That's not something you can cut.

The ceiling grinds lower, showering you with dust and fragments of concrete.

>saw man
That's not something you can cut.

The ceiling grinds lower, showering you with dust and fragments of concrete.

>saw leg
(of the Marcus)
You saw through his ankle. His body jerks violently, but he remains unconscious. The chain finally drops.

The ceiling comes down with terrible finality.
There is no escape.

Everything goes black.

    *** The End ***

Would you like to RESTART, RESTORE a saved game, QUIT or UNDO the last command?

* * *

>saw man
That's not something you can cut.

The ceiling grinds lower, showering you with dust and fragments of concrete.

>saw marcus
That's not something you can cut.

The ceiling grinds lower, showering you with dust and fragments of concrete.

>cut man
That's not something you can cut.

The ceiling comes down with terrible finality.
There is no escape.

Everything goes black.

    *** The End ***

Would you like to RESTART, RESTORE a saved game, QUIT or UNDO the last command?

* * *

>n
You throw yourself through the doorway as the ceiling crashes down behind you.
You survived - at a terrible cost.

(first opening the cell exit door)

Exit Hall
A narrow concrete corridor stretches into darkness. The air is colder here, heavier. Whatever comes next, you have left the cell behind.

To the north, you can see a heavy metal door marked with biohazard symbols. Behind it, you hear the faint hum of fluorescent lights.

I beg your pardon?

* * *

>take gauze
Taken.

>take tape
Taken.

>z
Time passes.

I beg your pardon?

>z
Time passes.

* * *

>z
Time passes.

BZZZZT!

A loud buzzer echoes through the chamber. The lights flicker and turn red.

A distorted voice booms from hidden speakers: "YOU HAVE IGNORED THE RULES FOR TOO LONG. THE PUZZLE IS NOW ACTIVE. STEP ON THE COLORED PLATES IN THE CORRECT SEQUENCE TO UNLOCK THE DOOR. EACH MISTAKE WILL COST YOU A PIECE OF YOURSELF. YOU HAVE THREE CHANCES. FAIL THREE TIMES, AND YOU WILL NEVER LEAVE."

The pressure plates on the floor begin to glow ominously.

>press blue
It is fixed in place.

>step on bluee
You can't see any such thing.

>step on bluee
You can't see any such thing.

>step on blue
You step on the BLUE plate. It glows brighter and emits a low tone.

* * *

>step on yellow
You step on the YELLOW plate. It glows brighter and emits a low tone.

>step on green
You step on the GREEN plate. It glows brighter and emits a low tone.

The plates flash GREEN in sequence. You hear a heavy CLUNK as the door mechanism unlocks.

Behind you, the entrance door SLAMS shut and locks with a mechanical THUNK. There is no going back.

>e
(first opening the chamber exit door)

>move chair under vent
You drag the metal chair across the floor, positioning it directly beneath the air vent. It's not tall enough on its own - you'll need something else.

* * *

>move cabinet under vent
You push the heavy filing cabinet with great effort, slowly moving it across the floor until it's positioned beneath the air vent. The chair is already there. You manage to stack the cabinet and chair together, creating a precarious tower.

>reach vent
You carefully climb onto the filing cabinet, then step up onto the chair balanced on top. The tower wobbles dangerously, but you steady yourself.

You reach toward the vent grate...

SNAP!
 Hidden mechanisms activate instantly. Metal clamps shoot out from the wall, clamping around your wrist!

Metal clamps shoot out and lock around your entire right arm - from shoulder to wrist! You're held firmly in place.

The monitors flicker to life. A distorted figure appears on every screen - The Jigsaw Killer.

"Welcome to your final test. You've come this far alone. Impressive.

Your arm is locked in place. Answer my question correctly, and you go free.

Answer incorrectly... and this mechanism will pull you into the saw blades behind you. You'll be torn apart."

The voice pauses.

"There is one other way... you can sacrifice your arm. Cut it off and escape. But with only one arm left, survival becomes... difficult.

The choice is yours."

The question appears on all the monitors:

"WHAT IS THE ONE THING THAT CAN BE GIVEN, BUT NEVER TAKEN BACK?"

You can ANSWER the question or use your SAW to cut your arm.

The monitors display: "ANSWER THE QUESTION OR CUT YOUR ARM. YOU HAVE 3 MOVES LEFT."

* * *

>z
Time passes.

Too much blood loss. Your vision goes black. 

You collapse to the floor, unconscious. 

You will never wake up.

    *** The End ***

Would you like to RESTART, RESTORE a saved game, QUIT or UNDO the last command?

>undo
Observation Room
[Previous turn undone.]

>bandage myself
You grit your teeth and wrap the gauze around your severed wrist, securing it tightly with the medical tape. The bleeding slows and finally stops. You might actually survive this.

* * *

>e
Dark Corridor
You step into a dark, narrow corridor. The walls are cold concrete, barely lit by a single flickering bulb at the far end.

Behind you, the door to the Observation Room stands open. Ahead, another door waits.

You walk alone. Marcus didn't make it.

This nightmare isn't over yet.

You can see an observation exit door and a jaw breaker door here.

>undo
Observation Room
[Previous turn undone.]

>n
You can't go that way.

* * *

>s
You can't go that way.

>w
Medical Chamber
You step into what appears to be an abandoned operating room. Rusted surgical tools hang from racks on blood-stained walls. A massive examination table dominates the center, covered in leather restraints. The floor is slick with something dark and viscous.

Three glass cylinders stand against the far wall, each containing a severed limb suspended in murky fluid. Above them, a digital counter reads: "SPECIMENS: 3 / 6"

The walls are lined with cabinets, some open, revealing medical supplies in various states of decay.

To the east, you can see a heavy metal door with a complex locking mechanism.

Four colored pressure plates (RED, BLUE, GREEN, and YELLOW) glow ominously on the floor near the chamber exit door.

You can see a bloody note on the floor.

* * *

>check cabinet
An open medical cabinet containing various supplies. You can see gauze, bandages, and medical tape inside.

In the open cabinet are a medical gauze and a medical tape.

Marcus's breathing is barely detectable. He's losing too much blood!

>take tape
Taken.

Marcus's body is going into shock. His pulse is fading. This is his last chance!

>take gauze
Taken.

Marcus's lips are turning blue. His eyes are rolling back. He's dying!

>bangade marcus
That's not a verb I recognise.

>bandage man
You can't see any such thing.

>bandage marcus
You can't see any such thing.

>examine marcus
You can't see any such thing.

* * *

>take gauze
Taken.

* * *

>take tape
Taken.

>take note
Taken.

* * *

>e
(first opening the chamber exit door)
It seems to be locked.

>w
You can't go that way.

BZZZZT!

A loud buzzer echoes through the chamber. The lights flicker and turn red.

A distorted voice booms from hidden speakers: "YOU HAVE IGNORED THE RULES FOR TOO LONG. THE PUZZLE IS NOW ACTIVE. STEP ON THE COLORED PLATES IN THE CORRECT SEQUENCE TO UNLOCK THE DOOR. EACH MISTAKE WILL COST YOU A PIECE OF YOURSELF. YOU HAVE THREE CHANCES. FAIL THREE TIMES, AND YOU WILL NEVER LEAVE."

The pressure plates on the floor begin to glow ominously.

>step on blue plate
You step on the BLUE plate. It glows brighter and emits a low tone.

* * *

>step on green plate
You step on the GREEN plate. It glows brighter and emits a low tone.

The plates flash GREEN in sequence. You hear a heavy CLUNK as the door mechanism unlocks.

Behind you, the entrance door SLAMS shut and locks with a mechanical THUNK. There is no going back.

>e
(first opening the chamber exit door)

Observation Room
You step into what appears to be a surveillance room. The walls are lined with cracked monitors, most displaying nothing but static. A few still flicker with grainy footage of empty corridors and cells.

High on the far wall, thin beams of light pierce through an air vent grate. The light draws your attention upward - freedom might lie beyond that vent.

A metal chair sits in the corner, and a filing cabinet stands against the wall.

The room feels claustrophobic, as if it's watching you back.

You can see a chamber exit door, an observation exit door, a metal chair and a filing cabinet here.

>look
Observation Room
You step into what appears to be a surveillance room. The walls are lined with cracked monitors, most displaying nothing but static. A few still flicker with grainy footage of empty corridors and cells.

High on the far wall, thin beams of light pierce through an air vent grate. The light draws your attention upward - freedom might lie beyond that vent.

A metal chair sits in the corner, and a filing cabinet stands against the wall.

The room feels claustrophobic, as if it's watching you back.

You can see a chamber exit door, an observation exit door, a metal chair and a filing cabinet here.

* * *

>take gauze
Taken.

>lake note
That's not a verb I recognise.

>check note
A blood-stained note with shaky handwriting: "The order is written in the colors of water, fire, caution, and life. Blue flows first, Red burns second, Yellow warns third, Green grows last. BLUE - RED - YELLOW - GREEN"

* * *

>look
Medical Chamber
You step into what appears to be an abandoned operating room. Rusted surgical tools hang from racks on blood-stained walls. A massive examination table dominates the center, covered in leather restraints. The floor is slick with something dark and viscous.

Three glass cylinders stand against the far wall, each containing a severed limb suspended in murky fluid. Above them, a digital counter reads: "SPECIMENS: 3 / 6"

The walls are lined with cabinets, some open, revealing medical supplies in various states of decay.

To the east, you can see a heavy metal door with a complex locking mechanism.

You can see a bloody note on the floor.

>e
(first opening the chamber exit door)
It seems to be locked.

* * *

>s
Exit Hall
A narrow concrete corridor stretches into darkness. The air is colder here, heavier. Whatever comes next, you have left the cell behind.

To the north, you can see a heavy metal door marked with biohazard symbols. Behind it, you hear the faint hum of fluorescent lights.

>n
Medical Chamber
You step into what appears to be an abandoned operating room. Rusted surgical tools hang from racks on blood-stained walls. A massive examination table dominates the center, covered in leather restraints. The floor is slick with something dark and viscous.

Three glass cylinders stand against the far wall, each containing a severed limb suspended in murky fluid. Above them, a digital counter reads: "SPECIMENS: 3 / 6"

The walls are lined with cabinets, some open, revealing medical supplies in various states of decay.

To the east, you can see a heavy metal door with a complex locking mechanism.

You can see a bloody note on the floor.

BZZZZT!

A loud buzzer echoes through the chamber. The lights flicker and turn red.

A distorted voice booms from hidden speakers: "YOU HAVE IGNORED THE RULES FOR TOO LONG. THE PUZZLE IS NOW ACTIVE. STEP ON THE COLORED PLATES IN THE CORRECT SEQUENCE TO UNLOCK THE DOOR. EACH MISTAKE WILL COST YOU A PIECE OF YOURSELF. YOU HAVE THREE CHANCES. FAIL THREE TIMES, AND YOU WILL NEVER LEAVE."

The pressure plates on the floor begin to glow ominously.

>step on blue plate
You step on the BLUE plate. It glows brighter and emits a low tone.

* * *

>n
You can't go that way.

>e
(first opening the chamber exit door)

Observation Room
You step into what appears to be a surveillance room. The walls are lined with cracked monitors, most displaying nothing but static. A few still flicker with grainy footage of empty corridors and cells.

High on the far wall, thin beams of light pierce through an air vent grate. The light draws your attention upward - freedom might lie beyond that vent.

A metal chair sits in the corner, and a filing cabinet stands against the wall.

The room feels claustrophobic, as if it's watching you back.

You can see a chamber exit door, an observation exit door, a metal chair and a filing cabinet here.

* * *

>z
Time passes.

>take note
Taken.

BZZZZT!

A loud buzzer echoes through the chamber. The lights flicker and turn red.

A distorted voice booms from hidden speakers: "YOU HAVE IGNORED THE RULES FOR TOO LONG. THE PUZZLE IS NOW ACTIVE. STEP ON THE COLORED PLATES IN THE CORRECT SEQUENCE TO UNLOCK THE DOOR. EACH MISTAKE WILL COST YOU A PIECE OF YOURSELF. YOU HAVE THREE CHANCES. FAIL THREE TIMES, AND YOU WILL NEVER LEAVE."

The pressure plates on the floor begin to glow ominously.

>step on blue
You step on the BLUE plate. It glows brighter and emits a low tone.

* * *

>respond pain
You shout: "pain!"

The monitors flash RED.

"WRONG," the voice declares.

The monitors display: "INCORRECT. YOU HAVE 2 ATTEMPTs REMAINING."

You can try again.

The monitors flash red: "TIME IS RUNNING OUT! 2 MOVES LEFT!"

>respond pain
You shout: "pain!"

The monitors flash RED.

"WRONG," the voice declares.

The monitors display: "INCORRECT. YOU HAVE 1 ATTEMPT REMAINING."

You can try again.

The monitors flash red rapidly: "FINAL WARNING! 1 MOVE LEFT!"

>respond pain
You shout: "pain!"

The monitors flash RED.

"WRONG," the voice declares.

"YOU HAVE FAILED," the voice rasps.

The mechanisms activate.

The mechanism begins to pull you backward!

You feel the clamps dragging your arm toward the spinning saw blades behind you.

You scream as the blades tear into your flesh.

There is no mercy. No escape.

The saw rips through muscle, bone, and sinew.

Your body goes limp as the blades consume you.

This is the end.

The monitors go dark.

"TIME'S UP," the voice rasps.

The mechanism activates.

You feel the clamps pulling you backward - straight into the spinning saw blades!

You scream as the blades tear into your back, ripping through flesh and bone.

There is no mercy. No escape.

The blades consume you.

This is the end.

    *** The End ***

Would you like to RESTART, RESTORE a saved game, QUIT or UNDO the last command?

Please give one of the answers above.

Would you like to RESTART, RESTORE a saved game, QUIT or UNDO the last command?

>undo
Observation Room
[Previous turn undone.]

>respond trust
You shout: "TRUST!"

The monitors flash green.

The mechanical clamps release instantly. You fall, catching yourself on the furniture below.

"CORRECT," the voice booms. "You've learned the lesson. Trust is given freely, but once broken, it can never be restored."

The door at the far end of the room unlocks with a heavy CLUNK.

You are free.

>undo
Observation Room
[Previous turn undone.]

>reach vent
You can't reach the vent without both the cabinet and chair positioned beneath it.

>move chair under vent
The chair is already positioned under the vent.

>move cabinet under chair
You can't see any such thing.

>move cabinet under vent
You push the heavy filing cabinet with great effort, slowly moving it across the floor until it's positioned beneath the air vent. The chair is already there. You manage to stack the cabinet and chair together, creating a precarious tower.

* * *

>saw hand
You pull out the rusty hand saw from your pocket.

With your free hand, you bring it to your trapped arm and begin cutting through the flesh and bone.
 The pain is indescribable. The saw blade tears through muscle, grinds against bone.

But you don't stop.

Blood sprays everywhere.

CRACK!

Your arm falls away. You collapse to the ground, free but bleeding heavily from the shoulder.

You need to bandage your shoulder IMMEDIATELY or you will bleed out!

You have medical supplies available. Use them now!

The question monitor goes dark. The door at the far end of the room unlocks with a heavy CLUNK.

You are free. But at what cost?

Blood spurts from your severed wrist. You're losing blood fast! You need to bandage yourself NOW!

>bandage myself
You grit your teeth and wrap the gauze around your severed wrist, securing it tightly with the medical tape. The bleeding slows and finally stops. You might actually survive this.

* * *

>sit on chair
You take a deep breath and sit in the cold metal chair.

You reach up and pull the jaw breaker device down over your head.

The moment it settles into place, metal locks SNAP shut around your neck.

You're trapped.

The device is cold against your face. You can feel the internal mechanisms pressing against your jaw.

"Good," the voice says. "Let us begin."

The first question crackles through the speakers...

QUESTION 1: What is the capital of France?

>respond paris
You hear a confirmation tone.

"CORRECT."

You have 1 correct answer. You need 3 correct answers to pass.

The next question appears on the screen...

QUESTION 2: What is the largest ocean on Earth?

* * *

>respond pacific
You hear a confirmation tone.

"CORRECT."

You have 2 correct answers. You need 3 correct answers to pass.

The next question appears on the screen...

QUESTION 3: How many sides does a square have?

>respond 6
You hear an error tone.

"WRONG."

The device tightens slightly around your jaw. You feel pressure building.

"You have 2 wrong answers remaining before the device activates."

You have 2 correct answers. You need 3 correct answers to pass.

The next question appears...

QUESTION 4: What element does "Au" represent on the periodic table?

>respond aaaa
You hear an error tone.

"WRONG."

The device tightens slightly around your jaw. You feel pressure building.

"You have 1 wrong answer remaining before the device activates."

You have 2 correct answers. You need 3 correct answers to pass.

The next question appears...

QUESTION 5: Who wrote "Romeo and Juliet"?

>respond hamlet
You hear an error tone.

"WRONG."

You scream, but the device doesn't stop.

CRACK!

Your jaw shatters. Blood fills your mouth.

The device continues expanding.

CRUNCH!

Your skull splits open.

Darkness.

*** Press any key to continue ***

>z
Time passes.

    *** The End ***

Would you like to RESTART, RESTORE a saved game, QUIT or UNDO the last command?

>undo
Jaw Breaker Chamber
[Previous turn undone.]

>sit in chair
You're already wearing it.

>respond paris
You hear an error tone.

"WRONG."

The device tightens slightly around your jaw. You feel pressure building.

"You have 2 wrong answers remaining before the device activates."

You have 1 correct answer. You need 3 correct answers to pass.

The next question appears...

QUESTION 3: How many sides does a square have?

>undo
Jaw Breaker Chamber
[Previous turn undone.]

* * *

>respond 4
You hear a confirmation tone.

"CORRECT."

"You have answered 3 questions correctly. You have passed the test."

A compartment in the wall slides open with a mechanical hiss, revealing a brass key.

You can now TAKE the KEY to unlock the device and escape.

>take key
Taken.

>use key
I didn't understand that sentence.

>unlock device
What do you want to unlock the jaw breaker device with?

* * *

>unlock device with key
With trembling hands, you insert the key into the lock mechanism on the side of the device.

CLICK!

The locks release. The jaw breaker lifts away from your head.

You're free.

You stand up from the chair, breathing heavily. You survived.

The exit door unlocks with a heavy CLUNK.

>undo
Jaw Breaker Chamber
[Previous turn undone.]

* * *

>e
(first opening the chamber exit door)
It seems to be locked.

>e
(first opening the chamber exit door)
It seems to be locked.

>e
(first opening the chamber exit door)
It seems to be locked.

BZZZZT!

A loud buzzer echoes through the chamber. The lights flicker and turn red.

A distorted voice booms from hidden speakers: "YOU HAVE IGNORED THE RULES FOR TOO LONG. THE PUZZLE IS NOW ACTIVE. STEP ON THE COLORED PLATES IN THE CORRECT SEQUENCE TO UNLOCK THE DOOR. EACH MISTAKE WILL COST YOU A PIECE OF YOURSELF. YOU HAVE THREE CHANCES. FAIL THREE TIMES, AND YOU WILL NEVER LEAVE."

The pressure plates on the floor begin to glow ominously.

>step on blue plate
You step on the BLUE plate. It glows brighter and emits a low tone.

* * *

>take gauze
Taken.

>z
Time passes.

* * *

>step on green
You step on the GREEN plate. It glows brighter and emits a low tone.

The plates flash GREEN in sequence. You hear a heavy CLUNK as the door mechanism unlocks.

Behind you, the entrance door SLAMS shut and locks with a mechanical THUNK. There is no going back.

>n
You can't go that way.

* * *

>move chair under vent
You drag the metal chair across the floor, positioning it directly beneath the air vent. It's not tall enough on its own - you'll need something else.

>move cabinet under chair
You can't see any such thing.

* * *

>respond pain
You shout: "pain!"

The monitors flash RED.

"WRONG," the voice declares.

The monitors display: "INCORRECT. YOU HAVE 2 ATTEMPTs REMAINING."

You can try again.

The monitors flash red: "TIME IS RUNNING OUT! 2 MOVES LEFT!"

>respond money
You shout: "money!"

The monitors flash RED.

"WRONG," the voice declares.

The monitors display: "INCORRECT. YOU HAVE 1 ATTEMPT REMAINING."

You can try again.

The monitors flash red rapidly: "FINAL WARNING! 1 MOVE LEFT!"

>respond trust
You shout: "TRUST!"

The monitors flash green.

The mechanical clamps release instantly. You fall, catching yourself on the furniture below.

"CORRECT," the voice booms. "You've learned the lesson. Trust is given freely, but once broken, it can never be restored."

The door at the far end of the room unlocks with a heavy CLUNK.

You are free.

* * *

>undo
Observation Room
[Previous turn undone.]

>respond aaaa
You shout: "aaaa!"

The monitors flash RED.

"WRONG," the voice declares.

"YOU HAVE FAILED," the voice rasps.

The mechanisms activate.

The mechanism begins to pull you backward!

You feel the clamps dragging your arm toward the spinning saw blades behind you.

You scream as the blades tear into your flesh.

There is no mercy. No escape.

The saw rips through muscle, bone, and sinew.

Your body goes limp as the blades consume you.

This is the end.

    *** The End ***

Would you like to RESTART, RESTORE a saved game, QUIT or UNDO the last command?

>undo
Observation Room
[Previous turn undone.]

>saw arm
You pull out the rusty hand saw from your pocket.

With your free hand, you bring it to your trapped arm and begin cutting through the flesh and bone.
 The pain is indescribable. The saw blade tears through muscle, grinds against bone.

But you don't stop.

Blood sprays everywhere.

CRACK!

Your arm falls away. You collapse to the ground, free but bleeding heavily from the shoulder.

You need to bandage your shoulder IMMEDIATELY or you will bleed out!

You have medical supplies available. Use them now!

The question monitor goes dark. The door at the far end of the room unlocks with a heavy CLUNK.

You are free. But at what cost?

Blood spurts from your severed wrist. You're losing blood fast! You need to bandage yourself NOW!

>bandage myself
You grit your teeth and wrap the gauze around your severed wrist, securing it tightly with the medical tape. The bleeding slows and finally stops. You might actually survive this.

* * *

>e
Dark Corridor
You step into a dark, narrow corridor. The walls are cold concrete, barely lit by a single flickering bulb at the far end.

Behind you, the door to the Observation Room stands open. Ahead, another door waits.

You walk alone. Marcus didn't make it.

This nightmare isn't over yet.

You can see an observation exit door and a jaw breaker door here.

>look
Dark Corridor
You step into a dark, narrow corridor. The walls are cold concrete, barely lit by a single flickering bulb at the far end.

Behind you, the door to the Observation Room stands open. Ahead, another door waits.

You walk alone. Marcus didn't make it.

This nightmare isn't over yet.

You can see an observation exit door and a jaw breaker door here.

>e
(first opening the jaw breaker door)

As you step into the room, the door locks behind you automatically.

A distorted voice crackles from hidden speakers in the ceiling.

"Welcome, Adam. You've made it this far alone. Impressive.

This is the Jaw Breaker. A device designed to expand the human jaw beyond its breaking point.

Your test is simple: Sit on the chair. Put the device on your head. Answer five questions correctly.

You may get TWO questions wrong. But if you fail a third time... the device activates, and your skull will be crushed.

If you answer all five correctly - or survive with only two wrong answers - a compartment will open in the wall containing a key. That key will unlock both the device and the exit door.

Refuse to play, and you will never leave this room.

Your time starts... NOW."

>pun on device
That's not a verb I recognise.

>check device
A nightmarish contraption: a metal cage fitted with hydraulic pistons designed to force the jaws apart. Once activated, it will slowly expand until the victim's jaw is shattered and their skull is split open.

It hangs ominously above the chair, waiting.

>put on device on yourself
You can't see any such thing.

>take device
That's hardly portable.

>aproche device
That's not a verb I recognise.

>i
You are carrying:
  a medical gauze
  a medical tape
  a hand saw

>put jawbraker on head
You can't see any such thing.

>put device
What do you want to put the jaw breaker device in?

>put device on head
You can't see any such thing.

>put device on myself
(first taking the jaw breaker device)
That's hardly portable.

>sit on chair
You take a deep breath and sit in the cold metal chair.

You reach up and pull the jaw breaker device down over your head.

The moment it settles into place, metal locks SNAP shut around your neck.

You're trapped.

The device is cold against your face. You can feel the internal mechanisms pressing against your jaw.

"Good," the voice says. "Let us begin."

The first question crackles through the speakers...

QUESTION 1: What is the capital of France?

* * *

>respond pacific
You hear a confirmation tone.

"CORRECT."

You have 2 correct answers. You need 3 correct answers to pass.

The next question appears on the screen...

QUESTION 3: How many sides does a square have?

>respond 5
You hear an error tone.

"WRONG."

The device tightens slightly around your jaw. You feel pressure building.

"You have 2 wrong answers remaining before the device activates."

You have 2 correct answers. You need 3 correct answers to pass.

The next question appears...

QUESTION 4: What element does "Au" represent on the periodic table?

>repond gold
That's not a verb I recognise.

>respond uranium
You hear an error tone.

"WRONG."

The device tightens slightly around your jaw. You feel pressure building.

"You have 1 wrong answer remaining before the device activates."

You have 2 correct answers. You need 3 correct answers to pass.

The next question appears...

QUESTION 5: Who wrote "Romeo and Juliet"?

>respond hamlet
You hear an error tone.

"WRONG."

The device ACTIVATES.

You feel the mechanisms inside the cage begin to expand.

The metal presses against your jaw, forcing it open wider... wider...

You scream, but the device doesn't stop.

CRACK!

Your jaw shatters. Blood fills your mouth.

The device continues expanding.

CRUNCH!

Your skull splits open.

Darkness.

    *** The End ***

Would you like to RESTART, RESTORE a saved game, QUIT or UNDO the last command?

* * *

>z
Time passes.

BZZZZT!

A loud buzzer echoes through the chamber. The lights flicker and turn red.

A distorted voice booms from hidden speakers: "YOU HAVE IGNORED THE RULES FOR TOO LONG. THE PUZZLE IS NOW ACTIVE. STEP ON THE COLORED PLATES IN THE CORRECT SEQUENCE TO UNLOCK THE DOOR. EACH MISTAKE WILL COST YOU A PIECE OF YOURSELF. YOU HAVE THREE CHANCES. FAIL THREE TIMES, AND YOU WILL NEVER LEAVE."

The pressure plates on the floor begin to glow ominously.

>step on red plate
You step on the RED plate. It glows brighter and emits a low tone.

>step on red plate
You step on the RED plate. It glows brighter and emits a low tone.

WRONG!

The mechanical device LUNGES forward with terrifying speed. Before you can react, it clamps onto your left hand. You scream as the blade severs your hand at the wrist. The machine retracts, depositing your severed hand into the collection basin.

The digital counter updates: "SPECIMENS: 4 / 6"

The pain is unbearable, but you're still alive.

>step on blue
You step on the BLUE plate. It glows brighter and emits a low tone.

* * *

>step on yellow
You step on the YELLOW plate. It glows brighter and emits a low tone.

>step on green
You step on the GREEN plate. It glows brighter and emits a low tone.

The plates flash GREEN in sequence. You hear a heavy CLUNK as the door mechanism unlocks.

Behind you, the entrance door SLAMS shut and locks with a mechanical THUNK. There is no going back.

But blood continues to pour from your severed wrist. The pain is overwhelming. You need to stop the bleeding before you can leave, or you won't make it.

Blood spurts from your severed wrist. You're losing blood fast! You need to bandage yourself NOW!

>bandage  myself
You grit your teeth and wrap the gauze around your severed wrist, securing it tightly with the medical tape. The bleeding slows and finally stops. You might actually survive this.

>n
You can't go that way.

* * *

>move cabinet under vent
You push the heavy filing cabinet with great effort, slowly moving it across the floor until it's positioned beneath the air vent. The chair is already there. You manage to stack the cabinet and chair together, creating a precarious tower.

>reach vent
You carefully climb onto the filing cabinet, then step up onto the chair balanced on top. The tower wobbles dangerously, but you steady yourself.

You reach toward the vent grate...

SNAP!
 Hidden mechanisms activate instantly. Metal clamps shoot out from the wall, clamping around your wrist!

You're trapped, suspended in the air, held by your single hand.

The monitors flicker to life. A distorted figure appears on every screen - The Jigsaw Killer.

"Ah, you've come this far alone... but now your sacrifice has become your doom."

The mechanism begins to activate.

"One hand already gone, and now this one too. There is no escape. No way out. Just... the end."

You can try to STRUGGLE, but it's futile.

>struggle
You pull against the mechanism with all your remaining strength.

But it's futile.

The mechanism activates.

Your last hand is severed.

You fall to the ground.

With no hands, you cannot stop the bleeding.

Your vision fades.

This is the end.

    *** The End ***

Would you like to RESTART, RESTORE a saved game, QUIT or UNDO the last command?

>restart
You regain consciousness to the sound of chains and distant machinery.

A distorted voice fills the room.

(Type HELP for list of commands)

Saw Escape Room
An Interactive Fiction by Marko Sokser
Release 1 / Serial number 251215 / Inform 7 v10.1.2 / D

Cell
You wake up strapped to a rusted metal bed in a filthy concrete cell. A heavy iron shackle locks your ankle in place, connected by a thick chain to another body nearby. Dark stains cover the floor beneath you, old and dried. The air reeks of metal, mold, and something far worse.

There are no windows. No mercy. Only waiting.

You can see:
- The unconscious man chained beside you
- The heavy iron chain binding you both
- A glowing button on the wall

>take saw
You can't see any such thing.

>press button
You press the button.

A section of the far wall collapses, revealing a heavy metal door.

A rusty hand saw falls from the ceiling, landing between you and the unconscious man.

Hidden machinery roars to life inside the walls.
The ceiling shudders - then begins to descend.

The ceiling grinds lower, showering you with dust and fragments of concrete.

* * *

>respond trust
You shout: "TRUST!"

The monitors flash green.

The mechanical clamps release instantly. You fall, catching yourself on the furniture below.

"CORRECT," the voice booms. "You've learned the lesson. Trust is given freely, but once broken, it can never be restored."

The door at the far end of the room unlocks with a heavy CLUNK.

You are free.

>n
You can't go that way.

* * *

>undo
Observation Room
[Previous turn undone.]

>respond pain
You haven't triggered the trap yet.

>reach vent
You carefully climb onto the filing cabinet, then step up onto the chair balanced on top. The tower wobbles dangerously, but you steady yourself.

You reach toward the vent grate...

SNAP!
 Hidden mechanisms activate instantly. Metal clamps shoot out from the wall, clamping around your wrist!

Metal clamps shoot out and lock around your entire right arm - from shoulder to wrist! You're held firmly in place.

The monitors flicker to life. A distorted figure appears on every screen - The Jigsaw Killer.

"Welcome to your final test. You've come this far alone. Impressive.

Your arm is locked in place. Answer my question correctly, and you go free.

Answer incorrectly... and this mechanism will pull you into the saw blades behind you. You'll be torn apart."

The voice pauses.

"There is one other way... you can sacrifice your arm. Cut it off and escape. But with only one arm left, survival becomes... difficult.

The choice is yours."

The question appears on all the monitors:

"WHAT IS THE ONE THING THAT CAN BE GIVEN, BUT NEVER TAKEN BACK?"

You can ANSWER the question or use your SAW to cut your arm.

The monitors display: "ANSWER THE QUESTION OR CUT YOUR ARM. YOU HAVE 3 MOVES LEFT."

>respond pain
You already answered.

The monitors flash red: "TIME IS RUNNING OUT! 2 MOVES LEFT!"

>respond money
You already answered.

The monitors flash red rapidly: "FINAL WARNING! 1 MOVE LEFT!"

>respond fame
You already answered.

The monitors go dark.

"TIME'S UP," the voice rasps.

The mechanism activates.

You feel the clamps pulling you backward - straight into the spinning saw blades!

You scream as the blades tear into your back, ripping through flesh and bone.

There is no mercy. No escape.

The blades consume you.

This is the end.

    *** The End ***

Would you like to RESTART, RESTORE a saved game, QUIT or UNDO the last command?

>undo
Observation Room
[Previous turn undone.]

>respond trust
You already answered.

The monitors go dark.

"TIME'S UP," the voice rasps.

The mechanism activates.

You feel the clamps pulling you backward - straight into the spinning saw blades!

You scream as the blades tear into your back, ripping through flesh and bone.

There is no mercy. No escape.

The blades consume you.

This is the end.

    *** The End ***

Would you like to RESTART, RESTORE a saved game, QUIT or UNDO the last command?

>undo
Observation Room
[Previous turn undone.]

>respond trust
You already answered.

The monitors flash red rapidly: "FINAL WARNING! 1 MOVE LEFT!"

* * *

>z
Time passes.

>take tape
Taken.

>take gauze
Taken.

BZZZZT!

A loud buzzer echoes through the chamber. The lights flicker and turn red.

A distorted voice booms from hidden speakers: "YOU HAVE IGNORED THE RULES FOR TOO LONG. THE PUZZLE IS NOW ACTIVE. STEP ON THE COLORED PLATES IN THE CORRECT SEQUENCE TO UNLOCK THE DOOR. EACH MISTAKE WILL COST YOU A PIECE OF YOURSELF. YOU HAVE THREE CHANCES. FAIL THREE TIMES, AND YOU WILL NEVER LEAVE."

The pressure plates on the floor begin to glow ominously.

>step on red
You step on the RED plate. It glows brighter and emits a low tone.

>step on red
You step on the RED plate. It glows brighter and emits a low tone.

>step on red
You step on the RED plate. It glows brighter and emits a low tone.

WRONG!

The mechanical device LUNGES forward with terrifying speed. Before you can react, it clamps onto your left hand. You scream as the blade severs your hand at the wrist. The machine retracts, depositing your severed hand into the collection basin.

The digital counter updates: "SPECIMENS: 4 / 6"

The pain is unbearable, but you're still alive.

>step on red
You step on the RED plate. It glows brighter and emits a low tone.

>step on red
You step on the RED plate. It glows brighter and emits a low tone.

WRONG AGAIN!

The machine strikes once more. This time it takes your right hand. You fall to your knees, screaming. Blood pours from both wrists.

The counter updates: "SPECIMENS: 5 / 6"

>step on red
You step on the RED plate. It glows brighter and emits a low tone.

>step on red
You step on the RED plate. It glows brighter and emits a low tone.

WRONG FOR THE LAST TIME!

The machine grabs you by the neck, pulling you into its blades. There is no escape.

The counter updates: "SPECIMENS: 6 / 6"

Everything goes black.

*** Press any key to continue ***

>z
Time passes.

    *** The End ***

Would you like to RESTART, RESTORE a saved game, QUIT or UNDO the last command?

* * *

>step on blue plate
You step on the BLUE plate. It glows brighter and emits a low tone.

>step on blue plate
You step on the BLUE plate. It glows brighter and emits a low tone.

WRONG!

The mechanical device LUNGES forward with terrifying speed. Before you can react, it clamps onto your left hand. You scream as the blade severs your hand at the wrist. The machine retracts, depositing your severed hand into the collection basin.

The digital counter updates: "SPECIMENS: 4 / 6"

The pain is unbearable, but you're still alive.

>step on blue plate
You step on the BLUE plate. It glows brighter and emits a low tone.

* * *

>step on green plate
You step on the GREEN plate. It glows brighter and emits a low tone.

The plates flash GREEN in sequence. You hear a heavy CLUNK as the door mechanism unlocks.

Behind you, the entrance door SLAMS shut and locks with a mechanical THUNK. There is no going back.

But blood continues to pour from your severed wrist. The pain is overwhelming. You need to stop the bleeding before you can leave, or you won't make it.

>bandage myself
You need something to stop the bleeding with.

>take gauze
Taken.

* * *

>take tape
Taken.

>bandage myself
You grit your teeth and wrap the gauze around your severed wrist, securing it tightly with the medical tape. The bleeding slows and finally stops. You might actually survive this.

>unod
That's not a verb I recognise.

>undo
Medical Chamber
[Previous turn undone.]

>undo
"Undo" capacity exhausted. Sorry!

>look
Medical Chamber
You step into what appears to be an abandoned operating room. Rusted surgical tools hang from racks on blood-stained walls. A massive examination table dominates the center, covered in leather restraints. The floor is slick with something dark and viscous.

Three glass cylinders stand against the far wall, each containing a severed limb suspended in murky fluid. Above them, a digital counter reads: "SPECIMENS: 3 / 6"

The walls are lined with cabinets, some open, revealing medical supplies in various states of decay.

To the east, you can see a heavy metal door with a complex locking mechanism.

Four colored pressure plates (RED, BLUE, GREEN, and YELLOW) glow ominously on the floor near the chamber exit door.

You can see a bloody note on the floor.

>z
Time passes.

>>step on green plate
That's not a verb I recognise.

>step on blue
You step on the BLUE plate. It glows brighter and emits a low tone.

* * *

>step on red
You step on the RED plate. It glows brighter and emits a low tone.

>step on gree
You can't see any such thing.

>step on green
You step on the GREEN plate. It glows brighter and emits a low tone.

WRONG AGAIN!

The machine strikes once more. This time it takes your right hand. You fall to your knees, screaming. Blood pours from both wrists.

The counter updates: "SPECIMENS: 5 / 6"

* * *

>step on green plate
You step on the GREEN plate. It glows brighter and emits a low tone.

The plates flash GREEN in sequence. You hear a heavy CLUNK as the door mechanism unlocks.

Behind you, the entrance door SLAMS shut and locks with a mechanical THUNK. There is no going back.

But blood continues to pour from your severed wrist. The pain is overwhelming. You need to stop the bleeding before you can leave, or you won't make it.

>z
Time passes.

>look
Medical Chamber
You step into what appears to be an abandoned operating room. Rusted surgical tools hang from racks on blood-stained walls. A massive examination table dominates the center, covered in leather restraints. The floor is slick with something dark and viscous.

Three glass cylinders stand against the far wall, each containing a severed limb suspended in murky fluid. Above them, a digital counter reads: "SPECIMENS: 3 / 6"

The walls are lined with cabinets, some open, revealing medical supplies in various states of decay.

To the east, you can see a heavy metal door with a complex locking mechanism.

Four colored pressure plates (RED, BLUE, GREEN, and YELLOW) glow ominously on the floor near the chamber exit door.

You can see a bloody note on the floor.

>look
Medical Chamber
You step into what appears to be an abandoned operating room. Rusted surgical tools hang from racks on blood-stained walls. A massive examination table dominates the center, covered in leather restraints. The floor is slick with something dark and viscous.

Three glass cylinders stand against the far wall, each containing a severed limb suspended in murky fluid. Above them, a digital counter reads: "SPECIMENS: 3 / 6"

The walls are lined with cabinets, some open, revealing medical supplies in various states of decay.

To the east, you can see a heavy metal door with a complex locking mechanism.

Four colored pressure plates (RED, BLUE, GREEN, and YELLOW) glow ominously on the floor near the chamber exit door.

You can see a bloody note on the floor.

>loook
That's not a verb I recognise.

>look
Medical Chamber
You step into what appears to be an abandoned operating room. Rusted surgical tools hang from racks on blood-stained walls. A massive examination table dominates the center, covered in leather restraints. The floor is slick with something dark and viscous.

Three glass cylinders stand against the far wall, each containing a severed limb suspended in murky fluid. Above them, a digital counter reads: "SPECIMENS: 3 / 6"

The walls are lined with cabinets, some open, revealing medical supplies in various states of decay.

To the east, you can see a heavy metal door with a complex locking mechanism.

Four colored pressure plates (RED, BLUE, GREEN, and YELLOW) glow ominously on the floor near the chamber exit door.

You can see a bloody note on the floor.

>i
You are carrying:
  a hand saw

* * *

>z
Time passes.

BZZZZT!

A loud buzzer echoes through the chamber. The lights flicker and turn red.

A distorted voice booms from hidden speakers: "YOU HAVE IGNORED THE RULES FOR TOO LONG. THE PUZZLE IS NOW ACTIVE. STEP ON THE COLORED PLATES IN THE CORRECT SEQUENCE TO UNLOCK THE DOOR. EACH MISTAKE WILL COST YOU A PIECE OF YOURSELF. YOU HAVE THREE CHANCES. FAIL THREE TIMES, AND YOU WILL NEVER LEAVE."

The pressure plates on the floor begin to glow ominously.

>step on red
You step on the RED plate. It glows brighter and emits a low tone.

I beg your pardon?

>step on red
You step on the RED plate. It glows brighter and emits a low tone.

* * *

>step on red
You step on the RED plate. It glows brighter and emits a low tone.

WRONG!

The mechanical device LUNGES forward with terrifying speed. Before you can react, it clamps onto your left hand. You scream as the blade severs your hand at the wrist. The machine retracts, depositing your severed hand into the collection basin.

The digital counter updates: "SPECIMENS: 4 / 6"

The pain is unbearable, but you're still alive.

>step on blue
You step on the BLUE plate. It glows brighter and emits a low tone.

* * *

>e
(first opening the chamber exit door)

Blood spurts from your severed wrist. You're losing blood fast! You need to bandage yourself NOW!

>look
Observation Room
You step into what appears to be a surveillance room. The walls are lined with cracked monitors, most displaying nothing but static. A few still flicker with grainy footage of empty corridors and cells.

High on the far wall, thin beams of light pierce through an air vent grate. The light draws your attention upward - freedom might lie beyond that vent.

A metal chair sits in the corner, and a filing cabinet stands against the wall.

The room feels claustrophobic, as if it's watching you back.

You can see a chamber exit door, an observation exit door, a metal chair and a filing cabinet here.

Too much blood loss. Your vision goes black. 

You collapse to the floor, unconscious. 

You will never wake up.

    *** The End ***

Would you like to RESTART, RESTORE a saved game, QUIT or UNDO the last command?

>undo
Observation Room
[Previous turn undone.]

>bandage myself
You need something to stop the bleeding with.

Too much blood loss. Your vision goes black. 

You collapse to the floor, unconscious. 

You will never wake up.

    *** The End ***

Would you like to RESTART, RESTORE a saved game, QUIT or UNDO the last command?

* * *

>step on red plate
You step on the RED plate. It glows brighter and emits a low tone.

WRONG!

The mechanical device LUNGES forward with terrifying speed. Before you can react, it clamps onto your left hand. You scream as the blade severs your hand at the wrist. The machine retracts, depositing your severed hand into the collection basin.

The digital counter updates: "SPECIMENS: 4 / 6"

The pain is unbearable, but you're still alive.

>step on blue plate
You step on the BLUE plate. It glows brighter and emits a low tone.

* * *

>step on green
You step on the GREEN plate. It glows brighter and emits a low tone.

The plates flash GREEN in sequence. You hear a heavy CLUNK as the door mechanism unlocks.

Behind you, the entrance door SLAMS shut and locks with a mechanical THUNK. There is no going back.

But blood continues to pour from your severed wrist. The pain is overwhelming. You need to stop the bleeding before you can leave, or you won't make it.

Blood spurts from your severed wrist. You're losing blood fast! You need to bandage yourself NOW!

>bandage myself
You need something to stop the bleeding with.

Too much blood loss. Your vision goes black. 

You collapse to the floor, unconscious. 

You will never wake up.

    *** The End ***

Would you like to RESTART, RESTORE a saved game, QUIT or UNDO the last command?

>undo
Medical Chamber
[Previous turn undone.]

* * *

>n
You throw yourself through the doorway as the ceiling crashes down behind you.
You survived - at a terrible cost.

(first opening the cell exit door)

Exit Hall
A narrow concrete corridor stretches into darkness. The air is colder here, heavier. Whatever comes next, you have left the cell behind.

To the north, you can see a heavy metal door marked with biohazard symbols. Behind it, you hear the faint hum of fluorescent lights.

>z
Time passes.

* * *

>z
Time passes.

BZZZZT!

A loud buzzer echoes through the chamber. The lights flicker and turn red.

A distorted voice booms from hidden speakers: "YOU HAVE IGNORED THE RULES FOR TOO LONG. THE PUZZLE IS NOW ACTIVE. STEP ON THE COLORED PLATES IN THE CORRECT SEQUENCE TO UNLOCK THE DOOR. EACH MISTAKE WILL COST YOU A PIECE OF YOURSELF. YOU HAVE THREE CHANCES. FAIL THREE TIMES, AND YOU WILL NEVER LEAVE."

The pressure plates on the floor begin to glow ominously.

>z
Time passes.

>step on red
You step on the RED plate. It glows brighter and emits a low tone.

* * *

>save man
You grab him under the arms and begin dragging his limp body. Every second counts.

The ceiling grinds lower, showering you with dust and fragments of concrete.

>d
You can't go that way.

The ceiling grinds lower, showering you with dust and fragments of concrete.

>n
You throw yourself through the doorway, dragging him with you, as the ceiling crashes down behind you.
You both survived - at a terrible cost.

(first opening the exit door)

Exit Hall
A narrow concrete corridor stretches into darkness. The air is colder here, heavier. Whatever comes next, you have left the cell behind.

To the north, you can see a heavy metal door marked with biohazard symbols. Behind it, you hear the faint hum of fluorescent lights.

Marcus lies unconscious on the cold concrete floor, his bandaged ankle still seeping blood.

>n
As you enter the chamber, you notice Marcus's severed ankle is bleeding heavily. Blood pools beneath him, spreading across the floor. You need to do something quickly, or he won't make it.

Blood continues to pour from Marcus's wound. His breathing becomes more labored.

* * *

>n
As you enter the chamber, you notice The man's severed ankle is bleeding heavily. Blood pools beneath him, spreading across the floor. You need to do something quickly, or he won't make it.

Blood continues to pour from The man's wound. His breathing becomes more labored.

I beg your pardon?

>see
That's not a verb I recognise.

>look
Medical Chamber
You step into what appears to be an abandoned operating room. Rusted surgical tools hang from racks on blood-stained walls. A massive examination table dominates the center, covered in leather restraints. The floor is slick with something dark and viscous.

Three glass cylinders stand against the far wall, each containing a severed limb suspended in murky fluid. Above them, a digital counter reads: "SPECIMENS: 3 / 6"

The walls are lined with cabinets, some open, revealing medical supplies in various states of decay.

To the east, you can see a heavy metal door with a complex locking mechanism.

You can see a chamber exit door and a bloody note here.

Marcus's face is deathly pale. The pool of blood is growing rapidly.

>open cabinet
It isn't something you can open.

Marcus's breathing is barely detectable. He's losing too much blood!

>open surgical cabinets
It isn't something you can open.

Marcus's chest stops moving. The blood has stopped flowing because his heart has stopped beating. He is dead. You failed to save him.

* * *

>take tape
Taken.

The man's body is going into shock. His pulse is fading. This is his last chance!

>take guaze
You can't see any such thing.

>take gauze
Taken.

The man's lips are turning blue. His eyes are rolling back. He's dying!

* * *

>check man
The man lies unconscious on the chamber floor. His ankle is bandaged, and the bleeding has stopped. His breathing is shallow but stable.

>wake up man
That seems unnecessary.

>shake man
You grab his shoulder and shake him hard. His body reacts, but his eyes never open.

Whatever they injected into him has left him completely helpless.

The man's eyes suddenly flutter open. He gasps, looking around in confusion and pain. "What... where am I?" he croaks, his voice hoarse. He looks down at his bandaged ankle and then at you. "You... you saved me. I thought I was going to die in that cell."

>talk to man
Marcus looks at you with pain in his eyes. "We need to get out of here. Look for a way to open that door."

BZZZZT!

A loud buzzer echoes through the chamber. The lights flicker and turn red.

A distorted voice booms from hidden speakers: "YOU HAVE IGNORED THE RULES FOR TOO LONG. THE PUZZLE IS NOW ACTIVE. STEP ON THE COLORED PLATES IN THE CORRECT SEQUENCE TO UNLOCK THE DOOR. EACH MISTAKE WILL COST YOU A PIECE OF YOURSELF. YOU HAVE THREE CHANCES. FAIL THREE TIMES, AND YOU WILL NEVER LEAVE."

The pressure plates on the floor begin to glow ominously.

Marcus's voice trembles: "Oh God... we need to figure this out quickly. Look for clues!"

* * *

>wake up man
That seems unnecessary.

>shake man
You shake his shoulder firmly, calling out to him. His eyes suddenly flutter open. He gasps, looking around in confusion and pain. "What... where am I?" he croaks, his voice hoarse. He looks down at his bandaged ankle and then at you. "You... you saved me. I thought I was going to die in that cell."

>talk to man
Marcus looks at you with pain in his eyes. "We need to get out of here. Look for a way to open that door."

>look
Medical Chamber
You step into what appears to be an abandoned operating room. Rusted surgical tools hang from racks on blood-stained walls. A massive examination table dominates the center, covered in leather restraints. The floor is slick with something dark and viscous.

Three glass cylinders stand against the far wall, each containing a severed limb suspended in murky fluid. Above them, a digital counter reads: "SPECIMENS: 3 / 6"

The walls are lined with cabinets, some open, revealing medical supplies in various states of decay.

To the east, you can see a heavy metal door with a complex locking mechanism.

You can see a Marcus, a chamber exit door and a bloody note here.

BZZZZT!

A loud buzzer echoes through the chamber. The lights flicker and turn red.

A distorted voice booms from hidden speakers: "YOU HAVE IGNORED THE RULES FOR TOO LONG. THE PUZZLE IS NOW ACTIVE. STEP ON THE COLORED PLATES IN THE CORRECT SEQUENCE TO UNLOCK THE DOOR. EACH MISTAKE WILL COST YOU A PIECE OF YOURSELF. YOU HAVE THREE CHANCES. FAIL THREE TIMES, AND YOU WILL NEVER LEAVE."

The pressure plates on the floor begin to glow ominously.

Marcus's voice trembles: "Oh God... we need to figure this out quickly. Look for clues!"

>step on red plate
You step on the RED plate. It glows brighter and emits a low tone.

* * *

>step on green plate
You step on the GREEN plate. It glows brighter and emits a low tone.

>step on yellow plate
You step on the YELLOW plate. It glows brighter and emits a low tone.

WRONG!

The mechanical device LUNGES forward with terrifying speed. Before you can react, it clamps onto your left hand. You scream as the blade severs your hand at the wrist. The machine retracts, depositing your severed hand into the collection basin.

The digital counter updates: "SPECIMENS: 4 / 6"

The pain is unbearable, but you're still alive.

Marcus screams: "NO! Oh God, your hand! Try again, but be careful!"

>step on yellow plate
You step on the YELLOW plate. It glows brighter and emits a low tone.

>step on yellow plate
You step on the YELLOW plate. It glows brighter and emits a low tone.

>step on yellow plate
You step on the YELLOW plate. It glows brighter and emits a low tone.

WRONG AGAIN!

The machine strikes once more. This time it takes your right hand. You fall to your knees, screaming. Blood pours from both wrists.

The counter updates: "SPECIMENS: 5 / 6"

Marcus is crying: "Please, you have to get this right! One more mistake and..."

>step on yellow plate
You step on the YELLOW plate. It glows brighter and emits a low tone.

>step on yellow plate
You step on the YELLOW plate. It glows brighter and emits a low tone.

WRONG FOR THE LAST TIME!

The machine grabs you by the neck, pulling you into its blades. There is no escape.

The counter updates: "SPECIMENS: 6 / 6"

Everything goes black.

    *** The End ***

Would you like to RESTART, RESTORE a saved game, QUIT or UNDO the last command?

* * *

>bandage man
You quickly wrap the gauze around The man's severed ankle, securing it tightly with the medical tape. The bleeding slows and finally stops. His breathing stabilizes slightly. He might actually survive this.

The man's eyes suddenly flutter open. He gasps, looking around in confusion and pain. "What... where am I?" he croaks, his voice hoarse. He looks down at his bandaged ankle and then at you. "You... you saved me. I thought I was going to die in that cell."

>shake man
He's already awake.

* * *

>i
You are carrying:
  a medical tape
  a medical gauze
  a hand saw

>check myselfd
You can't see any such thing.

>check myself
As good-looking as ever.

BZZZZT!

A loud buzzer echoes through the chamber. The lights flicker and turn red.

A distorted voice booms from hidden speakers: "YOU HAVE IGNORED THE RULES FOR TOO LONG. THE PUZZLE IS NOW ACTIVE. STEP ON THE COLORED PLATES IN THE CORRECT SEQUENCE TO UNLOCK THE DOOR. EACH MISTAKE WILL COST YOU A PIECE OF YOURSELF. YOU HAVE THREE CHANCES. FAIL THREE TIMES, AND YOU WILL NEVER LEAVE."

The pressure plates on the floor begin to glow ominously.

Marcus's voice trembles: "Oh God... we need to figure this out quickly. Look for clues!"

>take note
Taken.

* * *

>w
You can't go that way.

>s
(first opening the medical chamber entrance door)
It seems to be locked.

>e
(first opening the chamber exit door)

Marcus limps in behind you, leaning against the wall for support. "Another room... another trap," he mutters. "We need to be careful."

* * *

>check vent
High on the far wall, approximately 3 meters up, an air vent grate allows thin beams of light to pierce through. The vent looks like it could be large enough to crawl through - if you could reach it. You'll need to position furniture beneath it to have any chance of reaching it.

>take chair
Taken.

>position chair
I didn't understand that sentence.

>position chair under vent
You drag the metal chair across the floor, positioning it directly beneath the air vent. It's not tall enough on its own - you'll need something else.

* * *

>position cabinet under vent
You push the heavy filing cabinet with great effort, slowly moving it across the floor until it's positioned beneath the air vent. The chair is already there. You manage to stack the cabinet and chair together, creating a precarious tower.

>climb up
You carefully climb onto the filing cabinet, then step up onto the chair balanced on top. The tower wobbles dangerously, but you steady yourself.

You reach toward the vent grate...

SNAP!
 Hidden mechanisms activate instantly. Metal clamps shoot out from the wall, clamping around your wrists!

BOTH your wrists are locked in the mechanisms! You're suspended in the air, completely helpless.

The monitors flicker to life. A distorted figure appears on every screen - The Jigsaw Killer.

"Welcome to your final test," the voice rasps. "You've learned about sacrifice. About pain. But have you learned about TRUST?

Both your hands are locked in place. In exactly 5 minutes, these mechanisms will sever them both. You will fall, and with no hands left, you will bleed out in seconds.

But there is a way to survive..."

The voice pauses for dramatic effect.

"I will ask you ONE question. Answer correctly, and the mechanism releases. Answer incorrectly... and you die.

However, your companion knows the answer. You may ask him for help.

But here's the twist: If you ask him, HE must decide whether to help you or save himself. If he tells you the truth, you both go free. If he lies to save himself, you die and he escapes alone.

The choice is yours. Do you trust him with your life?"

The question appears on all the monitors:

"WHAT IS THE ONE THING THAT CAN BE GIVEN, BUT NEVER TAKEN BACK?"

The monitors display: "ANSWER THE QUESTION OR ASK YOUR COMPANION. TIME IS RUNNING OUT."

>ask marcus
You look at Marcus desperately.

"Marcus! Do you know the answer?! Please!"

Marcus stares at you, his face conflicted. Sweat beads on his forehead.

The monitors display: "HE KNOWS THE ANSWER. WILL HE SAVE YOU... OR HIMSELF?"

Marcus's voice trembles: "I... I do know it. I remember... from before."

He pauses, looking between you and the chamber exit door.

"But if I tell you... we both go free. If I don't..."

He's considering betraying you.

You can see the internal struggle in his eyes.

What do you say?

(Type "confess your sins" or "lie to marcus")

* * *

>UNDO
Observation Room
[Previous turn undone.]

>lieto marcus
That's not a verb I recognise.

>lie to marcus
You force a calm expression.

"Marcus, listen to me. I saved you in the cell, didn't I? I could have left you to die, but I didn't. That has to count for something."

You're trying to manipulate him.

"You owe me your life. Now it's time to repay that debt. Tell me the answer. You know we'll both get out of here."

Marcus looks at you carefully. His eyes narrow.

"You're... you're lying," he says slowly. "I can see it in your eyes."

His expression hardens.

"You didn't save me out of kindness. You saved me because you thought you'd need me. As leverage. As a tool."

He steps back toward the exit.

He walks to the observation exit door. It unlocks for him.

"Now you'll never have mine."

He leaves.

The monitors flash RED.

"BETRAYAL COMPLETE," the voice announces.

The mechanisms activate.

Both blades cut through your wrists. You fall.

Blood pours from your wounds. You can't stop it.

Marcus's footsteps fade into the distance.

You can try to STRUGGLE or SHOUT, but time is running out...

>UNDO
Observation Room
[Previous turn undone.]

>lito to marcus
That's not a verb I recognise.

>lie to marcus
You force a calm expression.

"Marcus, listen to me. I saved you in the cell, didn't I? I could have left you to die, but I didn't. That has to count for something."

You're trying to manipulate him.

"You owe me your life. Now it's time to repay that debt. Tell me the answer. You know we'll both get out of here."

Marcus looks at you carefully. His eyes narrow.

"You're... you're lying," he says slowly. "I can see it in your eyes."

His expression hardens.

"You didn't save me out of kindness. You saved me because you thought you'd need me. As leverage. As a tool."

He steps back toward the exit.

He walks to the observation exit door. It unlocks for him.

"Now you'll never have mine."

He leaves.

The monitors flash RED.

"BETRAYAL COMPLETE," the voice announces.

The mechanisms activate.

Both blades cut through your wrists. You fall.

Blood pours from your wounds. You can't stop it.

Marcus's footsteps fade into the distance.

You can try to STRUGGLE or SHOUT, but time is running out...

I beg your pardon?

>UNDO
Observation Room
[Previous turn undone.]

>lie to marcus
You force a calm expression.

"Marcus, listen to me. I saved you in the cell, didn't I? I could have left you to die, but I didn't. That has to count for something."

You're trying to manipulate him.

"You owe me your life. Now it's time to repay that debt. Tell me the answer. You know we'll both get out of here."

Marcus looks at you carefully. His eyes narrow.

"You're... you're lying," he says slowly. "I can see it in your eyes."

His expression hardens.

"You didn't save me out of kindness. You saved me because you thought you'd need me. As leverage. As a tool."

He steps back toward the exit.

He walks to the observation exit door. It unlocks for him.

"Now you'll never have mine."

He leaves.

The monitors flash RED.

"BETRAYAL COMPLETE," the voice announces.

The mechanisms activate.

Both blades cut through your wrists. You fall.

Blood pours from your wounds. You can't stop it.

Marcus's footsteps fade into the distance.

You can try to STRUGGLE or SHOUT, but time is running out...

>look
Observation Room
You step into what appears to be a surveillance room. The walls are lined with cracked monitors, most displaying nothing but static. A few still flicker with grainy footage of empty corridors and cells.

High on the far wall, thin beams of light pierce through an air vent grate. The light draws your attention upward - freedom might lie beyond that vent.

A metal chair sits in the corner, and a filing cabinet stands against the wall.

The room feels claustrophobic, as if it's watching you back.

You can see a chamber exit door, a Marcus, an observation exit door and a filing cabinet here.

Your vision darkens. The blood loss is too much.

    *** The End ***

Would you like to RESTART, RESTORE a saved game, QUIT or UNDO the last command?

>UNDO
Observation Room
[Previous turn undone.]

* * *

>Struggle
You're too weak to do that.

Your vision darkens. The blood loss is too much.

    *** The End ***

Would you like to RESTART, RESTORE a saved game, QUIT or UNDO the last command?

>UNDO
Observation Room
[Previous turn undone.]

>SHOUT
You're too weak to do that.

Your vision darkens. The blood loss is too much.

    *** The End ***

Would you like to RESTART, RESTORE a saved game, QUIT or UNDO the last command?

>Restart
You regain consciousness to the sound of chains and distant machinery.

A distorted voice fills the room.

Saw Escape Room
An Interactive Fiction by Marko Sokser
Release 1 / Serial number 251213 / Inform 7 v10.1.2 / D

Cell
You wake up strapped to a rusted metal bed in a filthy concrete cell. A heavy iron shackle locks your ankle in place, connected by a thick chain to another body nearby. Dark stains cover the floor beneath you, old and dried. The air reeks of metal, mold, and something far worse.

There are no windows. No mercy. Only waiting.

You can see:
- The unconscious man chained beside you
- The heavy iron chain binding you both
- A glowing button on the wall

>press button
You press the button.

A section of the far wall collapses, revealing a heavy metal door.

A rusty hand saw falls from the ceiling, landing between you and the unconscious man.

Hidden machinery roars to life inside the walls.
The ceiling shudders - then begins to descend.

The ceiling grinds lower, showering you with dust and fragments of concrete.

* * *

>n
You throw yourself through the doorway as the ceiling crashes down behind you.
You survived - at a terrible cost.

(first opening the cell exit door)

Exit Hall
A narrow concrete corridor stretches into darkness. The air is colder here, heavier. Whatever comes next, you have left the cell behind.

To the north, you can see a heavy metal door marked with biohazard symbols. Behind it, you hear the faint hum of fluorescent lights.

>n
As you enter the chamber, you notice The man's severed ankle is bleeding heavily. Blood pools beneath him, spreading across the floor. You need to do something quickly, or he won't make it.

Blood continues to pour from The man's wound. His breathing becomes more labored.

* * *

>step on blue plate
You step on the BLUE plate. It glows brighter and emits a low tone.

* * *

>pull up to vent
You can't see any such thing.

>reach vent
You carefully climb onto the filing cabinet, then step up onto the chair balanced on top. The tower wobbles dangerously, but you steady yourself.

You reach toward the vent grate...

SNAP!
 Hidden mechanisms activate instantly. Metal clamps shoot out from the wall, clamping around your wrists!

BOTH your wrists are locked in the mechanisms! You're suspended in the air, completely helpless.

The monitors flicker to life. A distorted figure appears on every screen - The Jigsaw Killer.

"Welcome to your final test," the voice rasps. "You've learned about sacrifice. About pain. But have you learned about TRUST?

Both your hands are locked in place. In exactly 5 minutes, these mechanisms will sever them both. You will fall, and with no hands left, you will bleed out in seconds.

But there is a way to survive..."

The voice pauses for dramatic effect.

"I will ask you ONE question. Answer correctly, and the mechanism releases. Answer incorrectly... and you die.

However, your companion knows the answer. You may ask him for help.

But here's the twist: If you ask him, HE must decide whether to help you or save himself. If he tells you the truth, you both go free. If he lies to save himself, you die and he escapes alone.

The choice is yours. Do you trust him with your life?"

The question appears on all the monitors:

"WHAT IS THE ONE THING THAT CAN BE GIVEN, BUT NEVER TAKEN BACK?"

The monitors display: "ANSWER THE QUESTION OR ASK YOUR COMPANION. TIME IS RUNNING OUT."

* * *

>e
You pause and look back one last time. Marcus's broken body lies in the jaw breaker chamber behind you.

He died because he trusted you. Or did he die because you trusted him?

The questions haunt you as you move forward.

Ahead, you see the final door. Whatever awaits you beyond... this is the end.

>e
(first opening the final entrance door)

You step into the control room. Monitors line the walls, surveillance equipment hums with dormant power.

In the center of the room stands a large computer terminal.

You can APPROACH the terminal or EXAMINE it.

>examine computer terminal
You approach the terminal. As you get closer, the screen flickers to life.

All the monitors around the room suddenly activate. Jigsaw's face appears on every screen.

"Welcome to the end, Adam. You have survived every trap, every test, every choice I set before you.

Marcus is dead. Whether by your hand or by fate, he is gone. You learned the price of trust... or the cost of betrayal.

But survival is not the same as understanding.

To leave this place, you must prove you have learned the lessons. Solve the final puzzle at the terminal.

And then... you will face one last choice.

Will you walk away... or will you seek revenge?

Choose wisely, Adam. Your life depends on it."

The screens go dark.

You can now EXAMINE the SCREEN to see the final test.

>examine screen
You lean closer to the terminal screen. Text begins to scroll across it:

FINAL TEST INITIALIZED.

I have tested your body. I have tested your mind. I have tested your morality.

Now I test your understanding.

Throughout your journey, you have encountered four key lessons: - What you gave up to survive - Who you relied on or betrayed - What you endured - The decisions that defined you

Enter the four-word code that represents these lessons. Format: WORD1 WORD2 WORD3 WORD4

Type: CODE (your answer)

Suddenly, an alarm begins to blare throughout the facility! Red lights flash.

You can now TYPE your answer into the terminal.

>respond sacrafice trust pain choice
There's no question to answer.

>CODE pain trust choice sacrafice
The terminal screen flashes RED.

"INCORRECT. 2 ATTEMPTS REMAINING."

Think carefully. What were the FOUR core lessons of your journey?

>CODE  sacrafice trust pain choice
The terminal screen flashes RED.

"INCORRECT. 1 ATTEMPTS REMAINING."

This is your LAST chance. Four words. Four lessons.

>CODE SACRIFICE TRUST PAIN CHOICE
The terminal screen flashes GREEN.

"CORRECT. YOU HAVE LEARNED THE LESSONS."

You hear heavy locks disengaging. Both doors - north and south - unlock simultaneously.

The terminal displays your final choice:

"FREEDOM lies to the NORTH. Walk away. Survive. Live with your scars.

REVENGE lies to the SOUTH. Confront me. Kill me. Die with me.

The choice is yours, Adam. I will not stop you either way.

What kind of person will you be?"

>n
You stand before the green door marked FREEDOM.

Marcus's face flashes in your mind. His death. His trust. His betrayal. His sacrifice.

You reach for the door handle...

...and pull it open.

Beyond the door is a staircase leading up. You can see daylight filtering down from above.

Fresh air. Freedom. Life.

The weight of the nightmare begins to lift from your shoulders.

(Press Z to continue)
You climb the stairs, leaving the nightmare behind.

---

You emerge into an abandoned warehouse district. The sun is setting. You're covered in blood, missing parts of yourself, but you're ALIVE.

You hear sirens in the distance. Help is coming.

Marcus didn't make it. That weight will stay with you forever.

But you survived.

Jigsaw is still out there. Still killing. Still testing.

But you're free.

(Press Z to continue)

>s
Marcus's face burns in your mind. His screams. His death. His trust that you FAILED.

You chose revenge.

You pull open the red door and step through.

(first opening the revenge door)

He speaks, his voice barely a whisper:

"You came for revenge. I expected nothing less. Marcus's death weighs on you. Good. It should.

But before you kill me, know this: I am already dying. Cancer. Inoperable. I have weeks, maybe days left.

You can end my suffering early. But this facility... it's rigged to explode if my heart stops. A failsafe.

Kill me, and we both die. You'll have your revenge, but you'll never see daylight again.

Or... you can walk away. Let me die slowly, painfully, as I deserve. And you live.

The choice, Adam, is yours."

You can KILL JIGSAW or LEAVE.

THE END

(You chose SURVIVAL over REVENGE)

    *** The End ***

Would you like to RESTART, RESTORE a saved game, QUIT or UNDO the last command?

>leave
Please give one of the answers above.

Would you like to RESTART, RESTORE a saved game, QUIT or UNDO the last command?

>kill jigsaw
Please give one of the answers above.

Would you like to RESTART, RESTORE a saved game, QUIT or UNDO the last command?

>z
Please give one of the answers above.

Would you like to RESTART, RESTORE a saved game, QUIT or UNDO the last command?

>z
Please give one of the answers above.

Would you like to RESTART, RESTORE a saved game, QUIT or UNDO the last command?

>undo
Control Room
[Previous turn undone.]

>n
The door is still locked. You need to solve the terminal puzzle first.

I beg your pardon?

>CODE SACRIFICE TRUST PAIN CHOICE
The terminal screen flashes GREEN.

"CORRECT. YOU HAVE LEARNED THE LESSONS."

You hear heavy locks disengaging. Both doors - north and south - unlock simultaneously.

The terminal displays your final choice:

"FREEDOM lies to the NORTH. Walk away. Survive. Live with your scars.

REVENGE lies to the SOUTH. Confront me. Kill me. Die with me.

The choice is yours, Adam. I will not stop you either way.

What kind of person will you be?"

* * *

>undo
Control Room
[Previous turn undone.]

* * *

>leave
But you aren't in anything at the moment.

>n
Control Room
You enter what appears to be the heart of this nightmare - a surveillance control room filled with monitors, cables, and machinery.

Dozens of screens line the walls, displaying footage from all the rooms you've passed through: the cell, the medical chamber, the observation room, the jaw breaker chamber. You can see your own journey played back in silent horror.

In the center of the room sits a large computer terminal with a keyboard and screen. The screen displays:

"FINAL TEST INITIALIZED. PROVE YOU HAVE LEARNED THE LESSON."

To the north, you see a green door marked "EXIT - FREEDOM". To the south, you see a red door marked "JIGSAW - INNER SANCTUM".

Both doors are locked. The terminal seems to control them.

You can see a revenge door, a final entrance door and a freedom door here.

>s
Marcus's face burns in your mind. His screams. His death. His trust that you FAILED.

You chose revenge.

You pull open the red door and step through.

Jigsaw's Chamber
You enter a small, dimly lit room. Medical equipment lines the walls - ventilators, monitors, IV drips. The air smells of antiseptic and death.

In the center of the room, strapped to a medical bed, is a frail man in his 60s. His skin is pale, almost gray. Tubes run from his arms. His breathing is labored.

This is him. Jigsaw. The monster who orchestrated everything.

But he looks... human. Dying. Weak.

He turns his head slowly to look at you. His eyes are calm, almost serene.

"Hello, Adam," he rasps. "I knew you would come."

You can see a revenge door and Jigsaw here.

>leave
But you aren't in anything at the moment.

>leave jigsaw
You look at the dying man before you.

Marcus is dead. Killing Jigsaw won't bring him back.

"I'm not going to give you what you want," you say. "You want me to become like you. A killer.

I refuse.

You'll die slowly, painfully, alone. That's a better punishment than anything I could do."

Jigsaw's expression doesn't change. He simply nods, almost... respectfully.

"Perhaps you DID learn something after all, Adam. Go. Live. Remember."

You turn and walk back through the control room. You exit through the green door marked FREEDOM.

Beyond the door is a staircase leading up. You can see daylight filtering down from above.

Fresh air. Freedom. Life.

The weight of the nightmare begins to lift from your shoulders.

(Press Z to continue)
You climb the stairs, emerging into daylight.

---

You emerge into daylight. Free. Alive.

Marcus is gone. That pain will never fully heal.

But you chose life over death. Mercy over revenge.

And that makes all the difference.

(Press Z to continue)

>z
Time passes.

THE END

(You chose SURVIVAL and MERCY)

(You spared the dying man and walked away free)

    *** The End ***

Would you like to RESTART, RESTORE a saved game, QUIT or UNDO the last command?

* * *

>check cabinet
An open medical cabinet containing various supplies.

In the open cabinet are a medical gauze and a medical tape.

The man's breathing is barely detectable. He's losing too much blood!

>take gauze
Taken.

The man's body is going into shock. His pulse is fading. This is his last chance!

>take tape
Taken.

Marcus's chest stops moving. The blood has stopped flowing because his heart has stopped beating. He is dead. You failed to save him.

* * *

>take tape
Taken.

The man's lips are turning blue. His eyes are rolling back. He's dying!

>bandage man
You quickly wrap the gauze around the man's severed ankle, securing it tightly with the medical tape. The bleeding slows and finally stops. His breathing stabilizes slightly. He might actually survive this.

>check man
A man is chained beside you, his body limp and unnaturally still. His head hangs to one side. His breathing is shallow, barely noticeable.

The man's eyes suddenly flutter open. He gasps, looking around in confusion and pain. "What... where am I?" he croaks, his voice hoarse. He looks down at his bandaged ankle and then at you. "You... you saved me. I thought I was going to die in that cell."

>check cabinet
An open medical cabinet that appears to be empty now.

>look
Medical Chamber
You step into what appears to be an abandoned operating room. Rusted surgical tools hang from racks on blood-stained walls. A massive examination table dominates the center, covered in leather restraints. The floor is slick with something dark and viscous.

Three glass cylinders stand against the far wall, each containing a severed limb suspended in murky fluid. Above them, a digital counter reads: "SPECIMENS: 3 / 6"

The walls are lined with cabinets, some open, revealing medical supplies in various states of decay.

To the east, you can see a heavy metal door with a complex locking mechanism.

You can see a Marcus, a chamber exit door and a bloody note here.

>check marcus
A man is chained beside you, his body limp and unnaturally still. His head hangs to one side. His breathing is shallow, barely noticeable.

BZZZZT!

A loud buzzer echoes through the chamber. The lights flicker and turn red.

A distorted voice booms from hidden speakers: "YOU HAVE IGNORED THE RULES FOR TOO LONG. THE PUZZLE IS NOW ACTIVE. STEP ON THE COLORED PLATES IN THE CORRECT SEQUENCE TO UNLOCK THE DOOR. EACH MISTAKE WILL COST YOU A PIECE OF YOURSELF. YOU HAVE THREE CHANCES. FAIL THREE TIMES, AND YOU WILL NEVER LEAVE."

The pressure plates on the floor begin to glow ominously.

Marcus's voice trembles: "Oh God... we need to figure this out quickly. Look for clues!"

* * *

>take guaze
You can't see any such thing.

>check cabinet
An open medical cabinet containing various supplies. You can see gauze, bandages, and medical tape inside.

In the open cabinet is a medical gauze.

The man's lips are turning blue. His eyes are rolling back. He's dying!

>take gauze
Taken.

The man's chest stops moving. The blood has stopped flowing because his heart has stopped beating. He is dead. You failed to save him.

>bandage man
It's too late. He's already gone.

>i
You are carrying:
  a medical gauze
  a medical tape
  a hand saw

* * *

>n
As you enter the chamber, you notice The man's severed ankle is bleeding heavily. Blood pools beneath him, spreading across the floor. You need to do something quickly, or he won't make it.

Blood continues to pour from The man's wound. His breathing becomes more labored.

>n
You can't go that way.

Marcus's face is deathly pale. The pool of blood is growing rapidly.

* * *

>n
As you enter the chamber, you notice The man's severed ankle is bleeding heavily. Blood pools beneath him, spreading across the floor. You need to do something quickly, or he won't make it.

Blood continues to pour from The man's wound. His breathing becomes more labored.

>open cabinet
It isn't something you can open.

Marcus's face is deathly pale. The pool of blood is growing rapidly.

>open cabinet
It isn't something you can open.

Marcus's breathing is barely detectable. He's losing too much blood!

* * *

>open surgical cabinets
It isn't something you can open.

Marcus's chest stops moving. The blood has stopped flowing because his heart has stopped beating. He is dead. You failed to save him.

>open open cabinet
It isn't something you can open.

>open cabinet
It isn't something you can open.

>open cabinet
It isn't something you can open.

* * *

>bandage man
You quickly wrap the gauze around The man's severed ankle, securing it tightly with the medical tape. The bleeding slows and finally stops. His breathing stabilizes slightly. He might actually survive this.

>wake man
That seems unnecessary.

>look
Medical Chamber
You step into what appears to be an abandoned operating room. Rusted surgical tools hang from racks on blood-stained walls. A massive examination table dominates the center, covered in leather restraints. The floor is slick with something dark and viscous.

Three glass cylinders stand against the far wall, each containing a severed limb suspended in murky fluid. Above them, a digital counter reads: "SPECIMENS: 3 / 6"

The walls are lined with cabinets, some open, revealing medical supplies in various states of decay.

To the east, you can see a heavy metal door with a complex locking mechanism.

The man lies unconscious on the chamber floor. His ankle is bandaged, and the bleeding has stopped. His breathing is shallow but stable.

You can see a bloody note on the floor.

* * *

>take note
Taken.

>check note
A blood-stained note with shaky handwriting: "The order is written in the colors of water, fire, caution, and life. Blue flows first, Red burns second, Yellow warns third, Green grows last. BLUE - RED - YELLOW - GREEN"

The man's eyes suddenly flutter open. He gasps, looking around in confusion and pain. "What... where am I?" he croaks, his voice hoarse. He looks down at his bandaged ankle and then at you. "You... you saved me. I thought I was going to die in that cell."

>step on red plate
The plates don't respond. They haven't been activated yet.

>check man
Marcus sits against the wall, clutching his bandaged ankle. His face is pale but his eyes are alert, watching you with a mixture of fear and gratitude.

BZZZZT!

A loud buzzer echoes through the chamber. The lights flicker and turn red.

A distorted voice booms from hidden speakers: "YOU HAVE IGNORED THE RULES FOR TOO LONG. THE PUZZLE IS NOW ACTIVE. STEP ON THE COLORED PLATES IN THE CORRECT SEQUENCE TO UNLOCK THE DOOR. EACH MISTAKE WILL COST YOU A PIECE OF YOURSELF. YOU HAVE THREE CHANCES. FAIL THREE TIMES, AND YOU WILL NEVER LEAVE."

The pressure plates on the floor begin to glow ominously.

Marcus's voice trembles: "Oh God... we need to figure this out quickly. Look for clues!"

>step on red plate
You step on the RED plate. It glows brighter and emits a low tone.

* * *

>step on red plate
You step on the RED plate. It glows brighter and emits a low tone.

WRONG AGAIN!

The machine strikes once more. This time it takes your right hand. You fall to your knees, screaming. Blood pours from both wrists.

The counter updates: "SPECIMENS: 5 / 6"

Marcus is crying: "Please, you have to get this right! One more mistake and..."

>step blue plate
I didn't understand that sentence.

>check note
A blood-stained note with shaky handwriting: "The order is written in the colors of water, fire, caution, and life. Blue flows first, Red burns second, Yellow warns third, Green grows last. BLUE - RED - YELLOW - GREEN"

* * *

>step on yellow plate
You step on the YELLOW plate. It glows brighter and emits a low tone.

>step on green plate
You step on the GREEN plate. It glows brighter and emits a low tone.

The plates flash GREEN in sequence. You hear a heavy CLUNK as the door mechanism unlocks.

But as you take a step toward freedom, your vision blurs. Blood loss from both severed wrists is too severe. Everything goes dark before your eyes. 

You collapse to the floor, unconscious. 

You will never wake up.

    *** The End ***

Would you like to RESTART, RESTORE a saved game, QUIT or UNDO the last command?

>undo last command
Please give one of the answers above.

Would you like to RESTART, RESTORE a saved game, QUIT or UNDO the last command?

>UNDO
Medical Chamber
[Previous turn undone.]

>look
Medical Chamber
You step into what appears to be an abandoned operating room. Rusted surgical tools hang from racks on blood-stained walls. A massive examination table dominates the center, covered in leather restraints. The floor is slick with something dark and viscous.

Three glass cylinders stand against the far wall, each containing a severed limb suspended in murky fluid. Above them, a digital counter reads: "SPECIMENS: 3 / 6"

The walls are lined with cabinets, some open, revealing medical supplies in various states of decay.

To the east, you can see a heavy metal door with a complex locking mechanism.

Marcus sits against the wall, clutching his bandaged ankle. His face is pale but his eyes are alert, watching you with a mixture of fear and gratitude.

Four colored pressure plates (RED, BLUE, GREEN, and YELLOW) glow ominously on the floor near the exit door.

>check man
Marcus sits against the wall, clutching his bandaged ankle. His face is pale but his eyes are alert, watching you with a mixture of fear and gratitude.

>step on blue plate
You step on the BLUE plate. It glows brighter and emits a low tone.

WRONG FOR THE LAST TIME!

The machine grabs you by the neck, pulling you into its blades. There is no escape.

The counter updates: "SPECIMENS: 6 / 6"

Everything goes black.

    *** The End ***

Would you like to RESTART, RESTORE a saved game, QUIT or UNDO the last command?

Please give one of the answers above.

Would you like to RESTART, RESTORE a saved game, QUIT or UNDO the last command?

>UNDO
Medical Chamber
[Previous turn undone.]

>UNDO
Medical Chamber
[Previous turn undone.]

>check myseld
You can't see any such thing.

* * *

>check myself
As good-looking as ever.

>i
You are carrying:
  a bloody note
  a medical tape
  a medical gauze
  a hand saw

>step on blue plate
You step on the BLUE plate. It glows brighter and emits a low tone.

WRONG FOR THE LAST TIME!

The machine grabs you by the neck, pulling you into its blades. There is no escape.

The counter updates: "SPECIMENS: 6 / 6"

Everything goes black.

    *** The End ***

Would you like to RESTART, RESTORE a saved game, QUIT or UNDO the last command?

* * *

>check note
A blood-stained note with shaky handwriting: "The order is written in the colors of water, fire, caution, and life. Blue flows first, Red burns second, Yellow warns third, Green grows last. BLUE - RED - YELLOW - GREEN"

>check man
The man lies unconscious on the chamber floor. His ankle is bandaged, and the bleeding has stopped. His breathing is shallow but stable.

>look
Medical Chamber
You step into what appears to be an abandoned operating room. Rusted surgical tools hang from racks on blood-stained walls. A massive examination table dominates the center, covered in leather restraints. The floor is slick with something dark and viscous.

Three glass cylinders stand against the far wall, each containing a severed limb suspended in murky fluid. Above them, a digital counter reads: "SPECIMENS: 3 / 6"

The walls are lined with cabinets, some open, revealing medical supplies in various states of decay.

To the east, you can see a heavy metal door with a complex locking mechanism.

The man lies unconscious on the chamber floor. His ankle is bandaged, and the bleeding has stopped. His breathing is shallow but stable.

The man's eyes suddenly flutter open. He gasps, looking around in confusion and pain. "What... where am I?" he croaks, his voice hoarse. He looks down at his bandaged ankle and then at you. "You... you saved me. I thought I was going to die in that cell."

>look
Medical Chamber
You step into what appears to be an abandoned operating room. Rusted surgical tools hang from racks on blood-stained walls. A massive examination table dominates the center, covered in leather restraints. The floor is slick with something dark and viscous.

Three glass cylinders stand against the far wall, each containing a severed limb suspended in murky fluid. Above them, a digital counter reads: "SPECIMENS: 3 / 6"

The walls are lined with cabinets, some open, revealing medical supplies in various states of decay.

To the east, you can see a heavy metal door with a complex locking mechanism.

Marcus sits against the wall, clutching his bandaged ankle. His face is pale but his eyes are alert, watching you with a mixture of fear and gratitude.

BZZZZT!

A loud buzzer echoes through the chamber. The lights flicker and turn red.

A distorted voice booms from hidden speakers: "YOU HAVE IGNORED THE RULES FOR TOO LONG. THE PUZZLE IS NOW ACTIVE. STEP ON THE COLORED PLATES IN THE CORRECT SEQUENCE TO UNLOCK THE DOOR. EACH MISTAKE WILL COST YOU A PIECE OF YOURSELF. YOU HAVE THREE CHANCES. FAIL THREE TIMES, AND YOU WILL NEVER LEAVE."

The pressure plates on the floor begin to glow ominously.

Marcus's voice trembles: "Oh God... we need to figure this out quickly. Look for clues!"

>check note
A blood-stained note with shaky handwriting: "The order is written in the colors of water, fire, caution, and life. Blue flows first, Red burns second, Yellow warns third, Green grows last. BLUE - RED - YELLOW - GREEN"

* * *

>step on blue plate
You step on the BLUE plate. It glows brighter and emits a low tone.

>step on blue plate
You step on the BLUE plate. It glows brighter and emits a low tone.

WRONG!

The mechanical device LUNGES forward with terrifying speed. Before you can react, it clamps onto your left hand. You scream as the blade severs your hand at the wrist. The machine retracts, depositing your severed hand into the collection basin.

The digital counter updates: "SPECIMENS: 4 / 6"

The pain is unbearable, but you're still alive.

Marcus screams: "NO! Oh God, your hand! Try again, but be careful!"

>step on blue plate
You step on the BLUE plate. It glows brighter and emits a low tone.

>step on blue plate
You step on the BLUE plate. It glows brighter and emits a low tone.

WRONG AGAIN!

The machine strikes once more. This time it takes your right hand. You fall to your knees, screaming. Blood pours from both wrists.

The counter updates: "SPECIMENS: 5 / 6"

Marcus is crying: "Please, you have to get this right! One more mistake and..."

>step on blue plate
You step on the BLUE plate. It glows brighter and emits a low tone.

* * *

>step on red plate
You step on the RED plate. It glows brighter and emits a low tone.

>step on zellow plate
You can't see any such thing.

>step on yellow plate
You step on the YELLOW plate. It glows brighter and emits a low tone.

>step on green plate
You step on the GREEN plate. It glows brighter and emits a low tone.

The plates flash GREEN in sequence. You hear a heavy CLUNK as the door mechanism unlocks.

But as you take a step toward freedom, your vision blurs. Blood loss from both severed wrists is too severe. Everything goes dark before your eyes.

You collapse to the floor, unconscious. 

You will never wake up.

    *** The End ***

Would you like to RESTART, RESTORE a saved game, QUIT or UNDO the last command?

>undo
Medical Chamber
[Previous turn undone.]

* * *

>step on blue plate
You step on the BLUE plate. It glows brighter and emits a low tone.

WRONG FOR THE LAST TIME!

The machine grabs you by the neck, pulling you into its blades. There is no escape.

The counter updates: "SPECIMENS: 6 / 6"

Everything goes black.

    *** The End ***

Would you like to RESTART, RESTORE a saved game, QUIT or UNDO the last command?

>UNSO
Please give one of the answers above.

Would you like to RESTART, RESTORE a saved game, QUIT or UNDO the last command?

>UNDO
Medical Chamber
[Previous turn undone.]

>step on green plate
You step on the GREEN plate. It glows brighter and emits a low tone.

The plates flash GREEN in sequence. You hear a heavy CLUNK as the door mechanism unlocks.

But as you take a step toward freedom, your vision blurs. Blood loss from both severed wrists is too severe. Everything goes dark before your eyes.

You collapse to the floor, unconscious. 

You will never wake up.

    *** The End ***

Would you like to RESTART, RESTORE a saved game, QUIT or UNDO the last command?

* * *

>take gauze
Taken.

The man's breathing is barely detectable. He's losing too much blood!

>z
Time passes.

The man's body is going into shock. His pulse is fading. This is his last chance!

I beg your pardon?

>z
Time passes.

The man's lips are turning blue. His eyes are rolling back. He's dying!

>z
Time passes.

The man's chest stops moving. The blood has stopped flowing because his heart has stopped beating. He is dead. You failed to save him.

>undo
Medical Chamber
[Previous turn undone.]

>bandage man
You quickly wrap the gauze around The man's severed ankle, securing it tightly with the medical tape. The bleeding slows and finally stops. His breathing stabilizes slightly. He might actually survive this.

* * *

>check man
The man lies unconscious on the chamber floor. His ankle is bandaged, and the bleeding has stopped. His breathing is shallow but stable.

>check man
The man lies unconscious on the chamber floor. His ankle is bandaged, and the bleeding has stopped. His breathing is shallow but stable.

* * *

>take note
Taken.

>z
Time passes.

The man's eyes suddenly flutter open. He gasps, looking around in confusion and pain. "What... where am I?" he croaks, his voice hoarse. He looks down at his bandaged ankle and then at you. "You... you saved me. I thought I was going to die in that cell."

BZZZZT!

A loud buzzer echoes through the chamber. The lights flicker and turn red.

A distorted voice booms from hidden speakers: "YOU HAVE IGNORED THE RULES FOR TOO LONG. THE PUZZLE IS NOW ACTIVE. STEP ON THE COLORED PLATES IN THE CORRECT SEQUENCE TO UNLOCK THE DOOR. EACH MISTAKE WILL COST YOU A PIECE OF YOURSELF. YOU HAVE THREE CHANCES. FAIL THREE TIMES, AND YOU WILL NEVER LEAVE."

The pressure plates on the floor begin to glow ominously.

Marcus's voice trembles: "Oh God... we need to figure this out quickly. Look for clues!"

>step on blue
You step on the BLUE plate. It glows brighter and emits a low tone.

* * *

>ask marcus
You look at Marcus desperately.

"Marcus! Do you know the answer?! Please!"

Marcus stares at you, his face conflicted. Sweat beads on his forehead.

The monitors display: "HE KNOWS THE ANSWER. WILL HE SAVE YOU... OR HIMSELF?"

Marcus's voice trembles: "I... I do know it. I remember... from before."

He pauses, looking between you and the chamber exit door.

"But if I tell you... we both go free. If I don't..."

He's considering betraying you.

You can see the internal struggle in his eyes.

What do you say?

(Type "confess your sins" or "lie to marcus")

>lie to marcus
You force a calm expression.

"Marcus, listen to me. I saved you in the cell, didn't I? I could have left you to die, but I didn't. That has to count for something."

You're trying to manipulate him.

"You owe me your life. Now it's time to repay that debt. Tell me the answer. You know we'll both get out of here."

Marcus looks at you carefully. His eyes narrow.

"You're... you're lying," he says slowly. "I can see it in your eyes."

His expression hardens.

"You didn't save me out of kindness. You saved me because you thought you'd need me. As leverage. As a tool."

He steps back toward the exit.

He walks to the observation exit door. It unlocks for him.

"Now you'll never have mine."

He leaves.

The monitors flash RED.

"BETRAYAL COMPLETE," the voice announces.

The mechanisms activate.

Both blades cut through your wrists. You fall.

Blood pours from your wounds. You can't stop it.

Marcus's footsteps fade into the distance.

You can try to STRUGGLE or SHOUT, but time is running out...

>undo
Observation Room
[Previous turn undone.]

>confess your sins
You take a deep breath.

"Marcus... I need to tell you something."

Your voice cracks.

"In the cell... when I had to choose... I almost left you behind. I thought about saving only myself. Part of me wanted to."

Tears stream down your face.

"But I didn't. I saved you. And if I could do it again... I'd make the same choice. Because you're worth saving."

Marcus's eyes widen. His expression softens.

"You... you're telling the truth."

He steps closer.

"The answer is TRUST," he says clearly. "The thing that can be given but never taken back is TRUST."

The monitors flash GREEN.

The mechanical clamps release. You fall, catching yourself.

"CORRECT," the voice booms.

Marcus helps you down from the furniture.

"Thank you," he says quietly. "Thank you for being honest. Thank you for saving me."

The observation exit door unlocks with a heavy CLUNK.

You both survived.

>n
You can't go that way.

>e
Dark Corridor
You step into a dark, narrow corridor. The walls are cold concrete, barely lit by a single flickering bulb at the far end.

Behind you, the door to the Observation Room stands open. Ahead, another door waits.

Marcus walks beside you, limping but alive.

This nightmare isn't over yet.

You can see an observation exit door, a Marcus and a jaw breaker door here.

* * *

>struggle
There's nothing to struggle against.

"You had one simple choice," the voice says coldly. "And you chose wrong."

Everything goes black.

    *** The End ***

Would you like to RESTART, RESTORE a saved game, QUIT or UNDO the last command?

>undo
Jaw Breaker Chamber
[Previous turn undone.]

* * *

>u
You step into the control room. Monitors line the walls, surveillance equipment hums with dormant power.

In the center of the room stands a large computer terminal.

You can APPROACH the terminal or EXAMINE it.

>look
Control Room
You enter what appears to be the heart of this nightmare - a surveillance control room filled with monitors, cables, and machinery.

Dozens of screens line the walls, displaying footage from all the rooms you've passed through: the cell, the medical chamber, the observation room, the jaw breaker chamber. You can see your own journey played back in silent horror.

In the center of the room sits a large computer terminal with a keyboard and screen. The screen displays:

"FINAL TEST INITIALIZED. PROVE YOU HAVE LEARNED THE LESSON."

To the north, you see a green door marked "EXIT - FREEDOM". To the south, you see a red door marked "JIGSAW - INNER SANCTUM".

Both doors are locked. The terminal seems to control them.

You can see a final entrance door, a revenge door and a freedom door here.

>e
You can't go that way.

>n
The door is still locked. You need to solve the terminal puzzle first.

>w
Final Corridor
You step through the doorway, leaving Marcus's body behind. The corridor ahead is dimly lit by emergency lights. Blood still drips from your wounds, both physical and emotional.

You can see a heavy steel door at the end of the corridor, marked with a red biohazard symbol. Beyond it, you sense something... final.

You can see a final entrance door and a final corridor door here.

>s
You can't go that way.

>e
Control Room
You enter what appears to be the heart of this nightmare - a surveillance control room filled with monitors, cables, and machinery.

Dozens of screens line the walls, displaying footage from all the rooms you've passed through: the cell, the medical chamber, the observation room, the jaw breaker chamber. You can see your own journey played back in silent horror.

In the center of the room sits a large computer terminal with a keyboard and screen. The screen displays:

"FINAL TEST INITIALIZED. PROVE YOU HAVE LEARNED THE LESSON."

To the north, you see a green door marked "EXIT - FREEDOM". To the south, you see a red door marked "JIGSAW - INNER SANCTUM".

Both doors are locked. The terminal seems to control them.

You can see a final entrance door, a revenge door and a freedom door here.

>examine computer terminal
You approach the terminal. As you get closer, the screen flickers to life.

All the monitors around the room suddenly activate. Jigsaw's face appears on every screen.

"Welcome to the end, Adam. You have survived every trap, every test, every choice I set before you.

Marcus is dead. Whether by your hand or by fate, he is gone. You learned the price of trust... or the cost of betrayal.

But survival is not the same as understanding.

To leave this place, you must prove you have learned the lessons. Solve the final puzzle at the terminal.

And then... you will face one last choice.

Will you walk away... or will you seek revenge?

Choose wisely, Adam. Your life depends on it."

The screens go dark.

You can now EXAMINE the SCREEN to see the final test.

* * *

>CODE sacarafice trust pain choice
The terminal screen flashes RED.

"INCORRECT. 2 ATTEMPTS REMAINING."

Think carefully. What were the FOUR core lessons of your journey?

>code sacrifice trust pain choice
The terminal screen flashes GREEN.

"CORRECT. YOU HAVE LEARNED THE LESSONS."

You hear heavy locks disengaging. Both doors - north and south - unlock simultaneously.

The terminal displays your final choice:

"FREEDOM lies to the NORTH. Walk away. Survive. Live with your scars.

REVENGE lies to the SOUTH. Confront me. Kill me. Die with me.

The choice is yours, Adam. I will not stop you either way.

What kind of person will you be?"

>n
You stand before the green door marked FREEDOM.

Marcus's face flashes in your mind. His death. His trust. His betrayal. His sacrifice.

You reach for the door handle...

...and pull it open.

Beyond the door is a staircase leading up. You can see daylight filtering down from above.

Fresh air. Freedom. Life.

The weight of the nightmare begins to lift from your shoulders.

(Press Z to continue)
(first opening the freedom door)

You climb the stairs, leaving the nightmare behind.

---

You emerge into an abandoned warehouse district. The sun is setting. You're covered in blood, missing parts of yourself, but you're ALIVE.

You hear sirens in the distance. Help is coming.

Marcus didn't make it. That weight will stay with you forever.

But you survived.

Jigsaw is still out there. Still killing. Still testing.

But you're free.

(Press Z to continue)

* * *

>undo
Control Room
[Previous turn undone.]

>w
Final Corridor
You step through the doorway, leaving Marcus's body behind. The corridor ahead is dimly lit by emergency lights. Blood still drips from your wounds, both physical and emotional.

You can see a heavy steel door at the end of the corridor, marked with a red biohazard symbol. Beyond it, you sense something... final.

You can see a final entrance door and a final corridor door here.

>e
Control Room
You enter what appears to be the heart of this nightmare - a surveillance control room filled with monitors, cables, and machinery.

Dozens of screens line the walls, displaying footage from all the rooms you've passed through: the cell, the medical chamber, the observation room, the jaw breaker chamber. You can see your own journey played back in silent horror.

In the center of the room sits a large computer terminal with a keyboard and screen. The screen displays:

"FINAL TEST INITIALIZED. PROVE YOU HAVE LEARNED THE LESSON."

To the north, you see a green door marked "EXIT - FREEDOM". To the south, you see a red door marked "JIGSAW - INNER SANCTUM".

Both doors are locked. The terminal seems to control them.

You can see a final entrance door, a revenge door and a freedom door here.

>s
Marcus's face burns in your mind. His screams. His death. His trust that you FAILED.

You chose revenge.

You pull open the red door and step through.

(first opening the revenge door)

He speaks, his voice barely a whisper:

"You came for revenge. I expected nothing less. Marcus's death weighs on you. Good. It should.

But before you kill me, know this: I am already dying. Cancer. Inoperable. I have weeks, maybe days left.

You can end my suffering early. But this facility... it's rigged to explode if my heart stops. A failsafe.

Kill me, and we both die. You'll have your revenge, but you'll never see daylight again.

Or... you can walk away. Let me die slowly, painfully, as I deserve. And you live.

The choice, Adam, is yours."

You can KILL JIGSAW or LEAVE.

>leave jigsaw
You look at the dying man before you.

Marcus is dead. Killing Jigsaw won't bring him back.

"I'm not going to give you what you want," you say. "You want me to become like you. A killer.

I refuse.

You'll die slowly, painfully, alone. That's a better punishment than anything I could do."

Jigsaw's expression doesn't change. He simply nods, almost... respectfully.

"Perhaps you DID learn something after all, Adam. Go. Live. Remember."

You turn and walk back through the control room. You exit through the green door marked FREEDOM.

Beyond the door is a staircase leading up. You can see daylight filtering down from above.

Fresh air. Freedom. Life.

The weight of the nightmare begins to lift from your shoulders.

(Press Z to continue)
You climb the stairs, emerging into daylight.

---

You emerge into daylight. Free. Alive.

Marcus is gone. That pain will never fully heal.

But you chose life over death. Mercy over revenge.

And that makes all the difference.

(Press Z to continue)

>undo
Jigsaw's Chamber
[Previous turn undone.]

>kill jigsaw
"This is for Marcus," you snarl through clenched teeth.

Your hands close around his frail throat with brutal force.

He doesn't resist. He simply watches you with those calm, knowing eyes - even now, in control.

That infuriates you MORE.

You SQUEEZE. Hard. Your fingers dig deep into his flesh, crushing his windpipe.

His eyes bulge. His face turns purple. Blood vessels burst in his eyes.

His body convulses, tubes ripping from his arms. Medical monitors SHRIEK in alarm.

You don't let go. You squeeze HARDER.

His breathing becomes desperate, wet, gurgling... then stops.

His body goes limp.

His heart stops beating.

For a moment, there is only silence.

The monster is dead. By YOUR hands.

Marcus is avenged.

(Press Z to continue)

* * *

>take note
Taken.

>take tape
Taken.

>look
Medical Chamber
You step into what appears to be an abandoned operating room. Rusted surgical tools hang from racks on blood-stained walls. A massive examination table dominates the center, covered in leather restraints. The floor is slick with something dark and viscous.

Three glass cylinders stand against the far wall, each containing a severed limb suspended in murky fluid. Above them, a digital counter reads: "SPECIMENS: 3 / 6"

The walls are lined with cabinets, some open, revealing medical supplies in various states of decay.

To the east, you can see a heavy metal door with a complex locking mechanism.

* * *

>step on green plate
You step on the GREEN plate. It glows brighter and emits a low tone.

The plates flash GREEN in sequence. You hear a heavy CLUNK as the door mechanism unlocks.

Behind you, the entrance door SLAMS shut and locks with a mechanical THUNK. There is no going back.

>look
Medical Chamber
You step into what appears to be an abandoned operating room. Rusted surgical tools hang from racks on blood-stained walls. A massive examination table dominates the center, covered in leather restraints. The floor is slick with something dark and viscous.

Three glass cylinders stand against the far wall, each containing a severed limb suspended in murky fluid. Above them, a digital counter reads: "SPECIMENS: 3 / 6"

The walls are lined with cabinets, some open, revealing medical supplies in various states of decay.

To the east, you can see a heavy metal door with a complex locking mechanism.

Four colored pressure plates (RED, BLUE, GREEN, and YELLOW) glow ominously on the floor near the chamber exit door.

>s
(first opening the medical chamber entrance door)
It seems to be locked.

>w
You can't go that way.

* * *

>look
Dark Corridor
You step into a dark, narrow corridor. The walls are cold concrete, barely lit by a single flickering bulb at the far end.

Behind you, the door to the Observation Room stands open. Ahead, another door waits.

You walk alone. Marcus didn't make it.

This nightmare isn't over yet.

You can see an observation exit door and a jaw breaker door here.

>e
(first opening the jaw breaker door)

As you step into the room, the door locks behind you automatically.

A distorted voice crackles from hidden speakers in the ceiling.

"Welcome, Adam. You've made it this far alone. Impressive.

This is the Jaw Breaker. A device designed to expand the human jaw beyond its breaking point.

Your test is simple: Put the device on your head. Answer five questions correctly.

You may get TWO questions wrong. But if you fail a third time... the device activates, and your skull will be crushed.

If you answer all five correctly - or survive with only two wrong answers - a compartment will open in the wall containing a key. That key will unlock both the device and the exit door.

Refuse to play, and you will never leave this room.

Your time starts... NOW."

>put on device
You take a deep breath and sit in the cold metal chair.

You reach up and pull the jaw breaker device down over your head.

The moment it settles into place, metal locks SNAP shut around your neck.

You're trapped.

The device is cold against your face. You can feel the internal mechanisms pressing against your jaw.

"Good," the voice says. "Let us begin."

The first question crackles through the speakers...

QUESTION 1: What is the capital of France?

>respond paris
You hear a confirmation tone.

"CORRECT."

You have 1 correct answer. You need 3 correct answers to pass.

The next question appears on the screen...

QUESTION 2: What is the largest ocean on Earth?

* * *

>respond 4
You hear a confirmation tone.

"CORRECT."

"You have answered 3 questions correctly. You have passed the test."

A compartment in the wall slides open with a mechanical hiss, revealing a brass key.

You can now TAKE the KEY to unlock the device and escape.

>respond silver
The puzzle isn't active.

>respond hamlet
The puzzle isn't active.

>take key
Taken.

>use key on device
You must supply a noun.

>unlock device
What do you want to unlock the jaw breaker device with?

>i
You are carrying:
  a jaw key
  a medical tape
  a bloody note
  a medical gauze
  a hand saw

>use jaw key on device
You must supply a second noun.

>use jaw key to unlock device
I didn't understand that sentence.

>use key on device
You must supply a noun.

>use key on jaw breaker
You must supply a second noun.

>insert key into device
That can't contain things.

>unlock device with key
With trembling hands, you insert the key into the lock mechanism on the side of the device.

CLICK!

The locks release. The jaw breaker lifts away from your head.

You're free.

You stand up from the chair, breathing heavily. You survived.

The exit door unlocks with a heavy CLUNK.

>n
You can't go that way.

* * *

>e
You've made it this far. Alone, wounded, but alive.

The final door looms ahead. Whatever waits beyond... you're ready.

>look
Final Corridor
You step through the doorway into a dimly lit corridor. Emergency lights flicker overhead, casting long shadows on the concrete walls.

At the end of the corridor, you can see a heavy steel door marked with a red biohazard symbol. This feels like the end of something.

You can see a final corridor door and a final entrance door here.

>e
(first opening the final entrance door)

You step into the control room. Monitors line the walls, surveillance equipment hums with dormant power.

In the center of the room stands a large computer terminal.

You can APPROACH the terminal or EXAMINE it.

>undo
Final Corridor
[Previous turn undone.]

>look
Final Corridor
You step through the doorway into a dimly lit corridor. Emergency lights flicker overhead, casting long shadows on the concrete walls.

At the end of the corridor, you can see a heavy steel door marked with a red biohazard symbol. This feels like the end of something.

You can see a final corridor door and a final entrance door here.

* * *

>e
(first opening the final entrance door)

You step into the control room. Monitors line the walls, surveillance equipment hums with dormant power.

In the center of the room stands a large computer terminal.

You can APPROACH the terminal or EXAMINE it.

>approach terminal
You approach the terminal. As you get closer, the screen flickers to life.

All the monitors around the room suddenly activate. Jigsaw's face appears on every screen.

"Welcome to the end, Adam. You have survived every trap, every test, every choice I set before you.

You came here alone, carrying only your own sins and sacrifices.

But survival is not the same as understanding.

To leave this place, you must prove you have learned the lessons. Solve the final puzzle at the terminal.

And then... you will face one last choice.

Will you walk away... or will you seek revenge?

Choose wisely, Adam. Your life depends on it."

The screens go dark.

You can now EXAMINE the SCREEN to see the final test.

>undo
Control Room
[Previous turn undone.]

>undo
Final Corridor
[Previous turn undone.]

>e
(first opening the final entrance door)

You step into the control room. Monitors line the walls, surveillance equipment hums with dormant power.

In the center of the room stands a large computer terminal.

You can APPROACH the terminal or EXAMINE it.

>examine terminal
Which do you mean, the computer terminal or the terminal screen?

>undo
Control Room
[Previous turn undone.]

* * *

>examine terminal
Which do you mean, the computer terminal or the terminal screen?

>EXAMINE terminal
Which do you mean, the computer terminal or the terminal screen?

>EXAMINE computer terminal
You approach the terminal. As you get closer, the screen flickers to life.

All the monitors around the room suddenly activate. Jigsaw's face appears on every screen.

"Welcome to the end, Adam. You have survived every trap, every test, every choice I set before you.

You came here alone, carrying only your own sins and sacrifices.

But survival is not the same as understanding.

To leave this place, you must prove you have learned the lessons. Solve the final puzzle at the terminal.

And then... you will face one last choice.

Will you walk away... or will you seek revenge?

Choose wisely, Adam. Your life depends on it."

The screens go dark.

You can now EXAMINE the SCREEN to see the final test.

>undo
Control Room
[Previous turn undone.]

>EXAMINE computer terminal
You approach the terminal. As you get closer, the screen flickers to life.

All the monitors around the room suddenly activate. Jigsaw's face appears on every screen.

"Welcome to the end, Adam. You have survived every trap, every test, every choice I set before you.

You came here alone, carrying only your own sins and sacrifices.

But survival is not the same as understanding.

To leave this place, you must prove you have learned the lessons. Solve the final puzzle at the terminal.

And then... you will face one last choice.

Will you walk away... or will you seek revenge?

Choose wisely, Adam. Your life depends on it."

The screens go dark.

You can now EXAMINE the SCREEN to see the final test.

>examine screen
You lean closer to the terminal screen. Text begins to scroll across it:

FINAL TEST INITIALIZED.

I have tested your body. I have tested your mind. I have tested your morality.

Now I test your understanding.

Throughout your journey, you have encountered four key lessons: - What you gave up to survive - Who you relied on or betrayed - What you endured - The decisions that defined you

Enter the four-word code that represents these lessons. Format: WORD1 WORD2 WORD3 WORD4

Type: CODE (your answer)

Suddenly, an alarm begins to blare throughout the facility! Red lights flash.

You can now TYPE your answer into the terminal.

>sacrafice trust pain pain
That's not a verb I recognise.

>sacrafice
That's not a verb I recognise.

>Type sacrafice pain trust choice
The terminal screen flashes RED.

"INCORRECT. 2 ATTEMPTS REMAINING."

Think carefully. What were the FOUR core lessons of your journey?

I beg your pardon?

>Type sacrafice pain trust choice
The terminal screen flashes RED.

"INCORRECT. 1 ATTEMPTS REMAINING."

This is your LAST chance. Four words. Four lessons.

>Type sacrafice pain trust choice
The terminal screen flashes RED.

"INCORRECT. 0 ATTEMPTS REMAINING."

>Type sacrafice pain trust choice
The terminal has locked you out after too many failed attempts.

The terminal screen flashes RED.

A computerized voice echoes: "INCORRECT. SELF-DESTRUCT SEQUENCE INITIATED."

Alarms blare. Red lights flash throughout the facility.

"You failed to learn," Jigsaw's voice echoes. "And now... it ends."

10... 9... 8...

The walls shake violently.

7... 6... 5...

You run for the door, but it's too late.

4... 3... 2... 1...

BOOM.

(Press Z to continue)
The entire facility explodes in a massive fireball.

You are consumed by the flames.

(Press Z to continue)

>undo
Control Room
[Previous turn undone.]

>Type sacrafice pain trust choice
The terminal has locked you out after too many failed attempts.

The terminal screen flashes RED.

A computerized voice echoes: "INCORRECT. SELF-DESTRUCT SEQUENCE INITIATED."

Alarms blare. Red lights flash throughout the facility.

"You failed to learn," Jigsaw's voice echoes. "And now... it ends."

10... 9... 8...

The walls shake violently.

7... 6... 5...

You run for the door, but it's too late.

4... 3... 2... 1...

BOOM.

(Press Z to continue)
The entire facility explodes in a massive fireball.

You are consumed by the flames.

(Press Z to continue)

* * *

>undo
Control Room
[Previous turn undone.]

>Type sacrafice pain trust choice
The terminal screen flashes RED.

"INCORRECT. 0 ATTEMPTS REMAINING."

* * *

>Type sacrafice pain trust choice
The terminal has locked you out after too many failed attempts.

The terminal screen flashes RED.

A computerized voice echoes: "INCORRECT. SELF-DESTRUCT SEQUENCE INITIATED."

Alarms blare. Red lights flash throughout the facility.

"You failed to learn," Jigsaw's voice echoes. "And now... it ends."

10... 9... 8...

The walls shake violently.

7... 6... 5...

You run for the door, but it's too late.

4... 3... 2... 1...

BOOM.

(Press Z to continue)
The entire facility explodes in a massive fireball.

You are consumed by the flames.

(Press Z to continue)

>z
Time passes.

THE END

(You failed the final test)

    *** The End ***

Would you like to RESTART, RESTORE a saved game, QUIT or UNDO the last command?

>undo
Control Room
[Previous turn undone.]

>type sacrafice trust pain choice
The terminal has locked you out after too many failed attempts.

The terminal screen flashes RED.

A computerized voice echoes: "INCORRECT. SELF-DESTRUCT SEQUENCE INITIATED."

Alarms blare. Red lights flash throughout the facility.

"You failed to learn," Jigsaw's voice echoes. "And now... it ends."

10... 9... 8...

The walls shake violently.

7... 6... 5...

You run for the door, but it's too late.

4... 3... 2... 1...

BOOM.

(Press Z to continue)
The entire facility explodes in a massive fireball.

You are consumed by the flames.

(Press Z to continue)

>undo
Control Room
[Previous turn undone.]

>TYPE SACRIFICE TRUST PAIN CHOICE
The terminal has locked you out after too many failed attempts.

The terminal screen flashes RED.

A computerized voice echoes: "INCORRECT. SELF-DESTRUCT SEQUENCE INITIATED."

Alarms blare. Red lights flash throughout the facility.

"You failed to learn," Jigsaw's voice echoes. "And now... it ends."

10... 9... 8...

The walls shake violently.

7... 6... 5...

You run for the door, but it's too late.

4... 3... 2... 1...

BOOM.

(Press Z to continue)
The entire facility explodes in a massive fireball.

You are consumed by the flames.

(Press Z to continue)

>undo
Control Room
[Previous turn undone.]

>TYPE SACRIFICE TRUST PAIN CHOICE
The terminal screen flashes GREEN.

"CORRECT. YOU HAVE LEARNED THE LESSONS."

You hear heavy locks disengaging. Both doors - north and south - unlock simultaneously.

The terminal displays your final choice:

"FREEDOM lies to the NORTH. Walk away. Survive. Live with your scars.

REVENGE lies to the SOUTH. Confront me. Kill me. Die with me.

The choice is yours, Adam. I will not stop you either way.

What kind of person will you be?"

>n
(first opening the freedom door)
You can't, since the freedom door leads nowhere.

>s
You chose revenge over survival.

You pull open the red door and step through.

(first opening the revenge door)

He speaks, his voice barely a whisper:

"You came for revenge. I expected nothing less. You seek to end the one who hurt you. I understand.

But before you kill me, know this: I am already dying. Cancer. Inoperable. I have weeks, maybe days left.

You can end my suffering early. But this facility... it's rigged to explode if my heart stops. A failsafe.

Kill me, and we both die. You'll have your revenge, but you'll never see daylight again.

Or... you can walk away. Let me die slowly, painfully, as I deserve. And you live.

The choice, Adam, is yours."

You can KILL JIGSAW or LEAVE.

* * *

>leave
But you aren't in anything at the moment.

>killjigsaw
That's not a verb I recognise.

>kill jigsaw
"This ends NOW," you growl.

Your hands close around his frail throat with brutal force.

He doesn't resist. He simply watches you with those calm, knowing eyes - even now, in control.

That infuriates you MORE.

You SQUEEZE. Hard. Your fingers dig deep into his flesh, crushing his windpipe.

His eyes bulge. His face turns purple. Blood vessels burst in his eyes.

His body convulses, tubes ripping from his arms. Medical monitors SHRIEK in alarm.

You don't let go. You squeeze HARDER.

His breathing becomes desperate, wet, gurgling... then stops.

His body goes limp.

His heart stops beating.

For a moment, there is only silence.

The monster is dead. By YOUR hands.

It's finally OVER.

(Press Z to continue)

>undo
Jigsaw's Chamber
[Previous turn undone.]

>leave
But you aren't in anything at the moment.

>LEAVE jigsaw
You look at the dying man before you.

Revenge won't heal your wounds.

"I'm not going to give you what you want," you say. "You want me to become like you. A killer.

I refuse.

You'll die slowly, painfully, alone. That's a better punishment than anything I could do."

Jigsaw's expression doesn't change. He simply nods, almost... respectfully.

"Perhaps you DID learn something after all, Adam. Go. Live. Remember."

You turn and walk back through the control room. You exit through the green door marked FREEDOM.

Beyond the door is a staircase leading up. You can see daylight filtering down from above.

Fresh air. Freedom. Life.

The weight of the nightmare begins to lift from your shoulders.

(Press Z to continue)
You climb the stairs, emerging into daylight.

---

You emerge into daylight. Free. Alive.

You survived, scarred but unbroken.

But you chose life over death. Mercy over revenge.

And that makes all the difference.

(Press Z to continue)

>z
Time passes.

THE END

(You chose SURVIVAL and MERCY)

(You spared the dying man and walked away free)

    *** The End ***

Would you like to RESTART, RESTORE a saved game, QUIT or UNDO the last command?

>undo
Jigsaw's Chamber
[Previous turn undone.]

* * *

>kill jigsaw
"This ends NOW," you growl.

Your hands close around his frail throat with brutal force.

He doesn't resist. He simply watches you with those calm, knowing eyes - even now, in control.

That infuriates you MORE.

You SQUEEZE. Hard. Your fingers dig deep into his flesh, crushing his windpipe.

His eyes bulge. His face turns purple. Blood vessels burst in his eyes.

His body convulses, tubes ripping from his arms. Medical monitors SHRIEK in alarm.

You don't let go. You squeeze HARDER.

His breathing becomes desperate, wet, gurgling... then stops.

His body goes limp.

His heart stops beating.

For a moment, there is only silence.

The monster is dead. By YOUR hands.

It's finally OVER.

(Press Z to continue)

>murder jigsaw
"This ends NOW," you growl.

Your hands close around his frail throat with brutal force.

He doesn't resist. He simply watches you with those calm, knowing eyes - even now, in control.

That infuriates you MORE.

You SQUEEZE. Hard. Your fingers dig deep into his flesh, crushing his windpipe.

His eyes bulge. His face turns purple. Blood vessels burst in his eyes.

His body convulses, tubes ripping from his arms. Medical monitors SHRIEK in alarm.

You don't let go. You squeeze HARDER.

His breathing becomes desperate, wet, gurgling... then stops.

His body goes limp.

His heart stops beating.

For a moment, there is only silence.

The monster is dead. By YOUR hands.

It's finally OVER.

(Press Z to continue)

>undo
Jigsaw's Chamber
[Previous turn undone.]

>look
Jigsaw's Chamber
You enter a small, dimly lit room. Medical equipment lines the walls - ventilators, monitors, IV drips. The air smells of antiseptic and death.

In the center of the room, strapped to a medical bed, is a frail man in his 60s. His skin is pale, almost gray. Tubes run from his arms. His breathing is labored.

This is him. Jigsaw. The monster who orchestrated everything.

But he looks... human. Dying. Weak.

He turns his head slowly to look at you. His eyes are calm, almost serene.

"Hello, Adam," he rasps. "I knew you would come."

You can see a revenge door and Jigsaw here.

>chech jigsaw
That's not a verb I recognise.

>kill jigsaw
"This ends NOW," you growl.

Your hands close around his frail throat with brutal force.

He doesn't resist. He simply watches you with those calm, knowing eyes - even now, in control.

That infuriates you MORE.

You SQUEEZE. Hard. Your fingers dig deep into his flesh, crushing his windpipe.

His eyes bulge. His face turns purple. Blood vessels burst in his eyes.

His body convulses, tubes ripping from his arms. Medical monitors SHRIEK in alarm.

You don't let go. You squeeze HARDER.

His breathing becomes desperate, wet, gurgling... then stops.

His body goes limp.

His heart stops beating.

For a moment, there is only silence.

The monster is dead. By YOUR hands.

It's finally OVER.

(Press Z to continue)

* * *

>z
Time passes.

Then...

A compartment in the wall suddenly slides open with a mechanical CLICK.

A small figure emerges on a mechanical track - a miniature PUPPET on a tricycle, dressed like Jigsaw.

Its eyes glow red. Its mouth opens...

"HAHAHAHAHA! I WANT TO PLAY A GAME!"

"HAHAHAHAHA! I WANT TO PLAY A GAME!"

The mechanical laugh echoes through the room.

(Press Z to continue)

>undo
Jigsaw's Chamber
[Previous turn undone.]

>z
Time passes.

Then...

A compartment in the wall suddenly slides open with a mechanical CLICK.

A small figure emerges on a mechanical track - a miniature PUPPET on a tricycle, dressed like Jigsaw.

Its eyes glow red. Its mouth opens...

"HAHAHAHAHA! I WANT TO PLAY A GAME!"

"HAHAHAHAHA! I WANT TO PLAY A GAME!"

The mechanical laugh echoes through the room.

(Press Z to continue)

* * *

>z
Time passes.

* * *

>z
Time passes.

The entire facility explodes in a massive fireball.

You and Jigsaw die together in the flames.

(Press Z to continue)

>z
Time passes.

THE END

(You chose REVENGE over SURVIVAL)
You ended the killer but you paid the ultimate price.

    *** The End ***

Would you like to RESTART, RESTORE a saved game, QUIT or UNDO the last command?

* * *

>save man
You grab him under the arms and begin dragging his limp body. Every second counts.

The ceiling grinds lower, showering you with dust and fragments of concrete.

>n
You throw yourself through the doorway, dragging him with you, as the ceiling crashes down behind you.
You both survived - at a terrible cost.

(first opening the exit door)

Exit Hall
A narrow concrete corridor stretches into darkness. The air is colder here, heavier. Whatever comes next, you have left the cell behind.

To the north, you can see a heavy metal door marked with biohazard symbols. Behind it, you hear the faint hum of fluorescent lights.

You can see an exit door and a Marcus here.

>w
You can't go that way.

>e
You can't go that way.

* * *

>s
The ceiling has completely collapsed. There is no way back.

>n
As you enter the chamber, you notice Marcus's severed ankle is bleeding heavily. Blood pools beneath him, spreading across the floor. You need to do something quickly, or he won't make it.

Blood continues to pour from Marcus's wound. His breathing becomes more labored.

* * *

>take saw
Taken.

The ceiling grinds lower, showering you with dust and fragments of concrete.

>saw lwg
You can't see any such thing.

>saw leg
(of the man)
You saw through his ankle. His body jerks violently, but he remains unconscious. The chain finally drops.

The ceiling grinds lower, showering you with dust and fragments of concrete.

* * *

>take tape
Taken.

The man's breathing is barely detectable. He's losing too much blood!

* * *

>take gauze
Taken.

The man's body is going into shock. His pulse is fading. This is his last chance!

>bandage man
You quickly wrap the gauze around The man's severed ankle, securing it tightly with the medical tape. The bleeding slows and finally stops. His breathing stabilizes slightly. He might actually survive this.

The man's eyes suddenly flutter open. He gasps, looking around in confusion and pain. "What... where am I?" he croaks, his voice hoarse. He looks down at his bandaged ankle and then at you. "You... you saved me. I thought I was going to die in that cell."

* * *

>check man
Marcus sits against the wall, clutching his bandaged ankle. His face is pale but his eyes are alert, watching you with a mixture of fear and gratitude.

>shake man
He's already awake.

>wake up man
That seems unnecessary.

>talk to man
Marcus looks at you with pain in his eyes. "We need to get out of here. Look for a way to open that door."

* * *

>look
Medical Chamber
You step into what appears to be an abandoned operating room. Rusted surgical tools hang from racks on blood-stained walls. A massive examination table dominates the center, covered in leather restraints. The floor is slick with something dark and viscous.

Three glass cylinders stand against the far wall, each containing a severed limb suspended in murky fluid. Above them, a digital counter reads: "SPECIMENS: 3 / 6"

The walls are lined with cabinets, some open, revealing medical supplies in various states of decay.

To the east, you can see a heavy metal door with a complex locking mechanism.

You can see a Marcus, a chamber exit door and a bloody note here.

>take note
Taken.

* * *

>read note
A blood-stained note with shaky handwriting: "The order is written in the colors of water, fire, caution, and life. Blue flows first, Red burns second, Yellow warns third, Green grows last. BLUE - RED - YELLOW - GREEN"

>step on plate
Which do you mean, the pressure plates, the red plate, the blue plate, the green plate or the yellow plate?

>stape on red plate
You can't see any such thing.

>step on red plate
You step on the RED plate. It glows brighter and emits a low tone.

* * *

>step on blue plate
You step on the BLUE plate. It glows brighter and emits a low tone.

>step on yellow plate
You step on the YELLOW plate. It glows brighter and emits a low tone.

>step on green plate
You step on the GREEN plate. It glows brighter and emits a low tone.

WRONG!

The mechanical device LUNGES forward with terrifying speed. Before you can react, it clamps onto your left hand. You scream as the blade severs your hand at the wrist. The machine retracts, depositing your severed hand into the collection basin.

The digital counter updates: "SPECIMENS: 4 / 6"

The pain is unbearable, but you're still alive.

Marcus screams: "NO! Oh God, your hand! Try again, but be careful!"

>step on green plate
You step on the GREEN plate. It glows brighter and emits a low tone.

>step on yellow plate
You step on the YELLOW plate. It glows brighter and emits a low tone.

>step on blue plate
You step on the BLUE plate. It glows brighter and emits a low tone.

>step on red plate
You step on the RED plate. It glows brighter and emits a low tone.

WRONG AGAIN!

The machine strikes once more. This time it takes your right hand. You fall to your knees, screaming. Blood pours from both wrists.

The counter updates: "SPECIMENS: 5 / 6"

Marcus is crying: "Please, you have to get this right! One more mistake and..."

* * *

>n
As you enter the chamber, you notice The man's severed ankle is bleeding heavily. Blood pools beneath him, spreading across the floor. You need to do something quickly, or he won't make it.

Blood continues to pour from The man's wound. His breathing becomes more labored.

>look
Medical Chamber
You step into what appears to be an abandoned operating room. Rusted surgical tools hang from racks on blood-stained walls. A massive examination table dominates the center, covered in leather restraints. The floor is slick with something dark and viscous.

Three glass cylinders stand against the far wall, each containing a severed limb suspended in murky fluid. Above them, a digital counter reads: "SPECIMENS: 3 / 6"

The walls are lined with cabinets, some open, revealing medical supplies in various states of decay.

To the east, you can see a heavy metal door with a complex locking mechanism.

You can see a chamber exit door and a bloody note here.

Marcus's face is deathly pale. The pool of blood is growing rapidly.

>check cabinet
An open medical cabinet containing various supplies. You can see gauze, bandages, and medical tape inside.

In the open cabinet are a medical gauze and a medical tape.

Marcus's breathing is barely detectable. He's losing too much blood!

>take gauze
Taken.

Marcus's body is going into shock. His pulse is fading. This is his last chance!

>take tape
Taken.

Marcus's lips are turning blue. His eyes are rolling back. He's dying!

* * *

>take saw
Taken.

The ceiling grinds lower, showering you with dust and fragments of concrete.

>saw man
That's not something you can cut.

The ceiling grinds lower, showering you with dust and fragments of concrete.

>n
You throw yourself through the doorway as the ceiling crashes down behind you.
You survived - at a terrible cost.

(first opening the exit door)

Exit Hall
A narrow concrete corridor stretches into darkness. The air is colder here, heavier. Whatever comes next, you have left the cell behind.

You can see an exit door here.

>w
You can't go that way.

>s
You throw yourself through the doorway as the ceiling crashes down behind you.
You survived - at a terrible cost.

Cell
You wake up strapped to a rusted metal bed in a filthy concrete cell. A heavy iron shackle locks your ankle in place, connected by a thick chain to another body nearby. Dark stains cover the floor beneath you, old and dried. The air reeks of metal, mold, and something far worse.

There are no windows. No mercy. Only waiting.

You can see an exit door, an other prisoner and a glowing button here.

* * *

>saw man
That's not something you can cut.

The ceiling grinds lower, showering you with dust and fragments of concrete.

>cut myself
You bite down and force the saw through bone and flesh. The pain is indescribable. You collapse - but the chain falls away.

The ceiling grinds lower, showering you with dust and fragments of concrete.

>save man
You are weak from blood loss. You can barely stand. You don't have the strength to drag him.

The ceiling grinds lower, showering you with dust and fragments of concrete.

>n
You throw yourself through the doorway as the ceiling crashes down behind you.
You survived - at a terrible cost.

(first opening the cell exit door)

Exit Hall
A narrow concrete corridor stretches into darkness. The air is colder here, heavier. Whatever comes next, you have left the cell behind.

To the north, you can see a heavy metal door marked with biohazard symbols. Behind it, you hear the faint hum of fluorescent lights.

* * *

>undo
Cell
[Previous turn undone.]

>save man
You are weak from blood loss. You can barely stand. You don't have the strength to drag him.

The ceiling comes down with terrible finality.
There is no escape.

Everything goes black.

*** Press any key to continue ***

>undo
Cell
[Previous turn undone.]

>undo
Cell
[Previous turn undone.]

>i
You are carrying nothing.

The ceiling grinds lower, showering you with dust and fragments of concrete.

>take saw
Taken.

The ceiling grinds lower, showering you with dust and fragments of concrete.

* * *

>save man
You grab him under the arms and begin dragging his limp body. Every second counts.

The ceiling comes down with terrible finality.
There is no escape.

Everything goes black.

*** Press any key to continue ***

>restart
Are you sure you want to restart?

>yes
You regain consciousness to the sound of chains and distant machinery.

A distorted voice fills the room.

(Type HELP for list of commands)

Saw Escape Room
An Interactive Fiction by Marko Sokser
Release 1 / Serial number 251215 / Inform 7 v10.1.2 / D

Cell
You wake up strapped to a rusted metal bed in a filthy concrete cell. A heavy iron shackle locks your ankle in place, connected by a thick chain to another body nearby. Dark stains cover the floor beneath you, old and dried. The air reeks of metal, mold, and something far worse.

There are no windows. No mercy. Only waiting.

You can see:
- The unconscious man chained beside you
- The heavy iron chain binding you both
- A glowing button on the wall

>press button
You press the button.

A section of the far wall collapses, revealing a heavy metal door.

A rusty hand saw falls from the ceiling, landing between you and the unconscious man.

Hidden machinery roars to life inside the walls.
The ceiling shudders - then begins to descend.

The ceiling grinds lower, showering you with dust and fragments of concrete.

* * *

>undo
Exit Hall
[Previous turn undone.]

>endo
That's not a verb I recognise.

>undo
Exit Hall
[Previous turn undone.]

>saw leg
(of yourself)
That would achieve nothing.

* * *

>take saw
Taken.

The ceiling grinds lower, showering you with dust and fragments of concrete.

>n
The chain prevents you from reaching the door.

The ceiling grinds lower, showering you with dust and fragments of concrete.

>e
You can't go that way.

The ceiling grinds lower, showering you with dust and fragments of concrete.

>s
You can't go that way.

The ceiling comes down with terrible finality.
There is no escape.

Everything goes black.

    *** The End ***

Would you like to RESTART, RESTORE a saved game, QUIT or UNDO the last command?

>undo
Cell
[Previous turn undone.]

>n
The chain prevents you from reaching the door.

The ceiling comes down with terrible finality.
There is no escape.

Everything goes black.

    *** The End ***

Would you like to RESTART, RESTORE a saved game, QUIT or UNDO the last command?

>undo
Cell
[Previous turn undone.]

>n
The chain prevents you from reaching the door.

The ceiling grinds lower, showering you with dust and fragments of concrete.

>saw leg
(of the man)
You saw through his ankle. His body jerks violently, but he remains unconscious. The chain finally drops.

The ceiling comes down with terrible finality.
There is no escape.

Everything goes black.

    *** The End ***

Would you like to RESTART, RESTORE a saved game, QUIT or UNDO the last command?

>undo
Cell
[Previous turn undone.]

* * *

>step on red
You step on the RED plate. It glows brighter and emits a low tone.

>step on red
You step on the RED plate. It glows brighter and emits a low tone.

WRONG FOR THE LAST TIME!

The machine grabs you by the neck, pulling you into its blades. There is no escape.

The counter updates: "SPECIMENS: 6 / 6"

Everything goes black.

    *** The End ***

Would you like to RESTART, RESTORE a saved game, QUIT or UNDO the last command?

* * *

>step on red
You step on the RED plate. It glows brighter and emits a low tone.

>step on red
You step on the RED plate. It glows brighter and emits a low tone.

WRONG FOR THE LAST TIME!

The machine grabs you by the neck, pulling you into its blades. There is no escape.

The counter updates: "SPECIMENS: 6 / 6"

Everything goes black.

*** Press any key to continue ***

    *** The End ***

Would you like to RESTART, RESTORE a saved game, QUIT or UNDO the last command?

* * *

>press button
You press the button.

A section of the far wall collapses, revealing a heavy metal door.

A rusty hand saw falls from the ceiling, landing between you and the unconscious man.

Hidden machinery roars to life inside the walls.
The ceiling shudders - then begins to descend.

The ceiling grinds lower, showering you with dust and fragments of concrete.

>z
Time passes.

The ceiling grinds lower, showering you with dust and fragments of concrete.

>z
Time passes.

The ceiling grinds lower, showering you with dust and fragments of concrete.

I beg your pardon?

>z
Time passes.

The ceiling grinds lower, showering you with dust and fragments of concrete.

>z
Time passes.

The ceiling comes down with terrible finality.
There is no escape.

Everything goes black.

*** Press any key to continue ***

    *** The End ***

Would you like to RESTART, RESTORE a saved game, QUIT or UNDO the last command?

>undo
Cell
[Previous turn undone.]

>restart
Are you sure you want to restart?

* * *

>take saw
Taken.

The ceiling grinds lower, showering you with dust and fragments of concrete.

>z
Time passes.

The ceiling grinds lower, showering you with dust and fragments of concrete.

* * *

>z
Time passes.

The ceiling comes down with terrible finality.
There is no escape.

Everything goes black.

*** Press any key to continue ***

    *** The End ***

Would you like to RESTART, RESTORE a saved game, QUIT or UNDO the last command?

Please give one of the answers above.

Would you like to RESTART, RESTORE a saved game, QUIT or UNDO the last command?

>z
Please give one of the answers above.

Would you like to RESTART, RESTORE a saved game, QUIT or UNDO the last command?

* * *

>z
Time passes.

The ceiling grinds lower, showering you with dust and fragments of concrete.

>z
Time passes.

The ceiling comes down with terrible finality.
There is no escape.

Everything goes black.

*** Press any key to continue ***

>z
Time passes.

The ceiling grinds lower, showering you with dust and fragments of concrete.

    *** The End ***

Would you like to RESTART, RESTORE a saved game, QUIT or UNDO the last command?

>undo
Cell
[Previous turn undone.]

* * *

>wake man
That seems unnecessary.

>shake man
You grab his shoulder and shake him hard. His body reacts, but his eyes never open.

Whatever they injected into him has left him completely helpless.

>check man
A man is chained beside you, his body limp and unnaturally still. His head hangs to one side. His breathing is shallow, barely noticeable.

* * *

>check chain
The heavy iron chain binds you to the other prisoner. Each of you wears a tight ankle shackle, far too small to slip free.

The chain passes through an iron bar embedded in the wall. There is no way to pull a body through it. This was engineered with precision.

>check if man alive
You can't see any such thing.

>check if man is alive
You force yourself to watch his chest. After several agonizing seconds, it rises slightly. He is alive.

* * *

>check button
A circular metal button embedded in the wall beside you. It pulses faintly, as if aware of your hesitation.

The glowing button is currently switched off.

>press button
You press the button.

A section of the far wall collapses, revealing a heavy metal door.

Hidden machinery roars to life inside the walls.
The ceiling shudders - then begins to descend.

The ceiling grinds lower, showering you with dust and fragments of concrete.

I beg your pardon?

>take saw
Taken.

The ceiling grinds lower, showering you with dust and fragments of concrete.

* * *

>cut man
Cutting him up would achieve little.

The ceiling grinds lower, showering you with dust and fragments of concrete.

>cut myseldf
You can't see any such thing.

>cut myself
You bite down and force the saw through bone and flesh. The pain is indescribable. You collapse - but the chain falls away.

The ceiling grinds lower, showering you with dust and fragments of concrete.

>cut man
Cutting him up would achieve little.

The ceiling grinds lower, showering you with dust and fragments of concrete.

>cut man
Cutting him up would achieve little.

The ceiling grinds lower, showering you with dust and fragments of concrete.

>cut prisioner
You can't see any such thing.

>cut pri
You can't see any such thing.

>cut prisoner
Cutting him up would achieve little.

The ceiling grinds lower, showering you with dust and fragments of concrete.

>n
You stumble forward, weak from blood loss. The ceiling crushes you before you reach the door.

The ceiling grinds lower, showering you with dust and fragments of concrete.